,DATE,TOTAL_CASES,NEW_CASES,TOTAL_CONFIRMED,NEW_CONFIRMED,TOTAL_PROBABLE,NEW_PROBABLE,POS_TESTS,NEG_TESTS,TOTAL_TESTS,NEW_TESTS,NEW_DEATHS,TOTAL_DEATHS,ACTIVE_CHANGE,TOTAL_ACTIVE,NEW_INACTIVE_RECOVERED,TOTAL_INACTIVE_RECOVERED,NEW_HOSP,TOTAL_HOSP,TOTAL_DEATHS_BY_DOD,NEW_DEATHS_BY_DOD
0,2022-04-16,2025209,211,1538366,164,486843,47,1722205,11146669,12868874,3676,0,26110,95,3072,116,1996027,0,48206,26102,0
1,2022-04-15,2024998,329,1538202,240,486796,89,1722023,11143175,12865198,7974,1,26110,165,2977,163,1995911,0,48206,26102,0
2,2022-04-14,2024669,431,1537962,293,486707,138,1721761,11135463,12857224,8089,4,26109,225,2812,202,1995748,1,48206,26102,2
3,2022-04-13,2024238,475,1537669,347,486569,128,1721462,11127673,12849135,9397,2,26105,278,2587,195,1995546,0,48205,26100,0
4,2022-04-12,2023763,324,1537322,232,486441,92,1721099,11118639,12839738,6473,61,26103,58,2309,205,1995351,2,48205,26100,2
5,2022-04-11,2023439,301,1537090,212,486349,89,1720851,11112414,12833265,3634,12,26042,61,2251,228,1995146,2,48203,26098,4
6,2022-04-10,2023138,130,1536878,76,486260,54,1720624,11109007,12829631,3703,1,26030,31,2190,98,1994918,1,48201,26094,2
7,2022-04-09,2023008,173,1536802,110,486206,63,1720536,11105392,12825928,6710,0,26029,87,2159,86,1994820,0,48200,26092,1
8,2022-04-08,2022835,295,1536692,218,486143,77,1720397,11098821,12819218,8259,8,26029,108,2072,179,1994734,1,48200,26091,2
9,2022-04-07,2022540,484,1536474,196,486066,288,1720165,11090794,12810959,8505,139,26021,182,1964,163,1994555,1,48199,26089,0
10,2022-04-06,2022056,383,1536278,239,485778,144,1719944,11082510,12802454,8630,5,25882,210,1782,168,1994392,1,48198,26089,5
11,2022-04-05,2021673,324,1536039,193,485634,131,1719661,11074163,12793824,5886,82,25877,64,1572,178,1994224,1,48197,26084,4
12,2022-04-04,2021349,244,1535846,155,485503,89,1719447,11068491,12787938,4273,127,25795,-98,1508,215,1994046,4,48196,26080,3
13,2022-04-03,2021105,92,1535691,51,485414,41,1719273,11064392,12783665,4358,24,25668,-32,1606,100,1993831,1,48192,26077,2
14,2022-04-02,2021013,190,1535640,92,485373,98,1719209,11060098,12779307,5978,0,25644,90,1638,100,1993731,1,48191,26075,5
15,2022-04-01,2020823,267,1535548,160,485275,107,1719099,11054230,12773329,7861,24,25644,41,1548,202,1993631,0,48190,26070,8
16,2022-03-31,2020556,283,1535388,203,485168,80,1718916,11046552,12765468,9543,15,25620,79,1507,189,1993429,1,48190,26062,4
17,2022-03-30,2020273,314,1535185,160,485088,154,1718688,11037237,12755925,8477,13,25605,104,1428,197,1993240,3,48189,26058,13
18,2022-03-29,2019959,260,1535025,162,484934,98,1718510,11028938,12747448,7940,18,25592,47,1324,195,1993043,2,48186,26045,16
19,2022-03-28,2019699,313,1534863,171,484836,142,1718326,11021182,12739508,5145,72,25574,-65,1277,306,1992848,1,48184,26029,7
20,2022-03-27,2019386,78,1534692,54,484694,24,1718127,11016236,12734363,2989,6,25502,-29,1342,101,1992542,3,48183,26022,5
21,2022-03-26,2019308,140,1534638,115,484670,25,1718061,11013313,12731374,6810,0,25496,47,1371,93,1992441,1,48180,26017,7
22,2022-03-25,2019168,215,1534523,155,484645,60,1717925,11006639,12724564,9339,0,25496,-26,1324,241,1992348,1,48179,26010,11
23,2022-03-24,2018953,249,1534368,134,484585,115,1717745,10997480,12715225,7768,8,25496,-35,1350,276,1992107,0,48178,25999,9
24,2022-03-23,2018704,322,1534234,176,484470,146,1717581,10989876,12707457,8445,31,25488,-29,1385,320,1991831,1,48178,25990,13
25,2022-03-22,2018382,339,1534058,180,484324,159,1717385,10981627,12699012,5695,10,25457,-28,1414,357,1991511,6,48177,25977,10
26,2022-03-21,2018043,298,1533878,205,484165,93,1717173,10976144,12693317,4224,27,25447,-172,1442,443,1991154,1,48171,25967,12
27,2022-03-20,2017745,158,1533673,132,484072,26,1716938,10972155,12689093,2672,4,25420,-52,1614,206,1990711,0,48170,25955,11
28,2022-03-19,2017587,167,1533541,117,484046,50,1716786,10969635,12686421,4771,0,25416,-67,1666,234,1990505,1,48170,25944,8
29,2022-03-18,2017420,334,1533424,216,483996,118,1716647,10965003,12681650,6139,11,25416,-83,1733,406,1990271,1,48169,25936,17
30,2022-03-17,2017086,310,1533208,203,483878,107,1716398,10959113,12675511,5776,14,25405,-257,1816,553,1989865,2,48168,25919,16
31,2022-03-16,2016776,364,1533005,239,483771,125,1716137,10953598,12669735,7540,17,25391,-168,2073,515,1989312,11,48166,25903,16
32,2022-03-15,2016412,395,1532766,202,483646,193,1715847,10946348,12662195,6258,8,25374,-198,2241,585,1988797,5,48155,25887,13
33,2022-03-14,2016017,368,1532564,200,483453,168,1715592,10940345,12655937,4921,146,25366,-594,2439,816,1988212,7,48150,25874,16
34,2022-03-13,2015649,173,1532364,110,483285,63,1715347,10935669,12651016,4340,6,25220,-184,3033,351,1987396,7,48143,25858,10
35,2022-03-12,2015476,139,1532254,93,483222,46,1715200,10931476,12646676,4351,0,25214,-283,3217,422,1987045,3,48136,25848,17
36,2022-03-11,2015337,471,1532161,277,483176,194,1715083,10927242,12642325,10550,214,25214,-526,3500,783,1986623,10,48133,25831,25
37,2022-03-10,2014866,436,1531884,264,482982,172,1714742,10917033,12631775,10162,183,25000,-652,4026,905,1985840,5,48123,25806,18
38,2022-03-09,2014430,632,1531620,348,482810,284,1714424,10907189,12621613,12901,49,24817,-504,4678,1087,1984935,13,48118,25788,16
39,2022-03-08,2013798,703,1531272,315,482526,388,1713995,10894717,12608712,7123,72,24768,-570,5182,1201,1983848,9,48105,25772,23
40,2022-03-07,2013095,601,1530957,377,482138,224,1713632,10887957,12601589,5980,26,24696,-874,5752,1449,1982647,15,48096,25749,21
41,2022-03-06,2012494,278,1530580,175,481914,103,1713168,10882441,12595609,5607,1,24670,-389,6626,666,1981198,8,48081,25728,16
42,2022-03-05,2012216,338,1530405,274,481811,64,1712947,10877055,12590002,9238,1,24669,-444,7015,781,1980532,10,48073,25712,33
43,2022-03-04,2011878,750,1530131,493,481747,257,1712619,10868145,12580764,13869,28,24668,-810,7459,1532,1979751,11,48063,25679,23
44,2022-03-03,2011128,796,1529638,434,481490,362,1712020,10854875,12566895,12526,23,24640,-1048,8269,1821,1978219,15,48052,25656,36
45,2022-03-02,2010332,1227,1529204,818,481128,409,1711501,10842868,12554369,12932,22,24617,-797,9317,2002,1976398,19,48037,25620,37
46,2022-03-01,2009105,1682,1528386,919,480719,763,1710523,10830914,12541437,8864,83,24595,-831,10114,2430,1974396,24,48018,25583,27
47,2022-02-28,2007423,1886,1527467,1089,479956,797,1709485,10823088,12532573,11193,65,24512,-1212,10945,3033,1971966,30,47994,25556,44
48,2022-02-27,2005537,78,1526378,77,479159,1,1708245,10813135,12521380,1630,12,24447,-1282,12157,1348,1968933,3,47964,25512,43
49,2022-02-26,2005459,665,1526301,490,479158,175,1708148,10811602,12519750,9661,0,24435,-911,13439,1576,1967585,11,47961,25469,34
50,2022-02-25,2004794,1667,1525811,1051,478983,616,1707540,10802549,12510089,14609,14,24435,-1273,14350,2926,1966009,32,47950,25435,33
51,2022-02-24,2003127,1982,1524760,1186,478367,796,1706334,10789146,12495480,12387,96,24421,-1769,15623,3655,1963083,20,47918,25402,46
52,2022-02-23,2001145,2248,1523574,1382,477571,866,1704967,10778126,12483093,12401,266,24325,-2003,17392,3985,1959428,22,47898,25356,46
53,2022-02-22,1998897,2663,1522192,1505,476705,1158,1703351,10767341,12470692,9550,95,24059,-2114,19395,4682,1955443,29,47876,25310,41
54,2022-02-21,1996234,1494,1520687,904,475547,590,1701645,10759497,12461142,6713,21,23964,-4930,21509,6403,1950761,22,47847,25269,42
55,2022-02-20,1994740,847,1519783,560,474957,287,1700607,10753822,12454429,6507,9,23943,-1913,26439,2751,1944358,11,47825,25227,46
56,2022-02-19,1993893,1308,1519223,923,474670,385,1699902,10748020,12447922,10668,11,23934,-1767,28352,3064,1941607,26,47814,25181,53
57,2022-02-18,1992585,2778,1518300,1790,474285,988,1698740,10738514,12437254,14970,26,23923,-2128,30119,4880,1938543,30,47788,25128,63
58,2022-02-17,1989807,3579,1516510,2514,473297,1065,1696644,10725640,12422284,18725,37,23897,-3000,32247,6542,1933663,45,47758,25065,70
59,2022-02-16,1986228,3862,1513996,2725,472232,1137,1693816,10709743,12403559,17920,53,23860,-4445,35247,8254,1927121,32,47713,24995,59
60,2022-02-15,1982366,3949,1511271,2753,471095,1196,1690748,10694891,12385639,12433,98,23807,-6081,39692,9932,1918867,45,47681,24936,70
61,2022-02-14,1978417,5208,1508518,2928,469899,2280,1687626,10685580,12373206,12384,362,23709,-7787,45773,12633,1908935,46,47636,24866,72
62,2022-02-13,1973209,1325,1505590,1001,467619,324,1684222,10676600,12360822,8328,61,23347,-3669,53560,4933,1896302,20,47590,24794,58
63,2022-02-12,1971884,2326,1504589,1761,467295,565,1683034,10669460,12352494,12725,3,23286,-3032,57229,5355,1891369,27,47570,24736,86
64,2022-02-11,1969558,5002,1502828,3606,466730,1396,1680936,10658833,12339769,18175,75,23283,-5805,60261,10732,1886014,60,47543,24650,73
65,2022-02-10,1964556,5674,1499222,3827,465334,1847,1676893,10644701,12321594,15316,65,23208,-7541,66066,13150,1875282,50,47483,24577,72
66,2022-02-09,1958882,6178,1495395,4497,463487,1681,1672600,10633678,12306278,18975,50,23143,-8166,73607,14294,1862132,60,47433,24505,74
67,2022-02-08,1952704,6204,1490898,3957,461806,2247,1667500,10619803,12287303,14897,62,23093,-11142,81773,17284,1847838,89,47373,24431,74
68,2022-02-07,1946500,6486,1486941,4033,459559,2453,1663030,10609376,12272406,13659,114,23031,-14661,92915,21033,1830554,67,47284,24357,90
69,2022-02-06,1940014,2963,1482908,2126,457106,837,1658575,10600172,12258747,8952,6,22917,-4591,107576,7548,1809521,53,47217,24267,94
70,2022-02-05,1937051,3840,1480782,2828,456269,1012,1656080,10593715,12249795,11082,3,22911,-4628,112167,8465,1801973,45,47164,24173,95
71,2022-02-04,1933211,7616,1477954,5539,455257,2077,1652853,10585860,12238713,21146,32,22908,-8890,116795,16474,1793508,64,47119,24078,64
72,2022-02-03,1925595,21734,1472415,6400,453180,15334,1646737,10570830,12217567,22622,75,22876,1687,125685,19972,1777034,73,47055,24014,79
73,2022-02-02,1903861,11240,1466015,8143,437846,3097,1639765,10555180,12194945,29544,67,22801,-13573,123998,24746,1757062,109,46982,23935,91
74,2022-02-01,1892621,12283,1457872,8726,434749,3557,1630772,10534629,12165401,26673,73,22734,-14681,137571,26891,1732316,80,46873,23844,93
75,2022-01-31,1880338,9658,1449146,6040,431192,3618,1620970,10517758,12138728,17403,155,22661,-9664,152252,19167,1705425,75,46793,23751,98
76,2022-01-30,1870680,5298,1443106,4022,427574,1276,1614550,10506775,12121325,14523,46,22506,-2322,161916,7574,1686258,49,46718,23653,96
77,2022-01-29,1865382,9798,1439084,7908,426298,1890,1610217,10496585,12106802,29583,5,22460,-492,164238,10285,1678684,47,46669,23557,85
78,2022-01-28,1855584,12843,1431176,9734,424408,3109,1601374,10475845,12077219,30705,118,22455,-7126,164730,19851,1668399,66,46622,23472,92
79,2022-01-27,1842741,17828,1421442,13738,421299,4090,1590934,10455580,12046514,39828,70,22337,-2838,171856,20596,1648548,85,46556,23380,103
80,2022-01-26,1824913,14459,1407704,11098,417209,3361,1576128,10430558,12006686,32690,68,22267,-6907,174694,21298,1627952,65,46471,23277,86
81,2022-01-25,1810454,15947,1396606,11635,413848,4312,1564169,10409827,11973996,29942,57,22199,-5431,181601,21321,1606654,77,46406,23191,73
82,2022-01-24,1794507,16297,1384971,11056,409536,5241,1551794,10392260,11944054,27555,86,22142,-7222,187032,23433,1585333,93,46329,23118,92
83,2022-01-23,1778210,8969,1373915,7669,404295,1300,1539994,10376505,11916499,20390,17,22056,265,194254,8687,1561900,58,46236,23026,80
84,2022-01-22,1769241,17118,1366246,14099,402995,3019,1531670,10364439,11896109,34748,0,22039,7121,193989,9997,1553213,79,46178,22946,66
85,2022-01-21,1752123,18077,1352147,14095,399976,3982,1516630,10344731,11861361,34263,118,22039,6645,186868,11314,1543216,82,46099,22880,81
86,2022-01-20,1734046,21575,1338052,16130,395994,5445,1501570,10325528,11827098,37730,138,21921,11160,180223,10277,1531902,90,46017,22799,90
87,2022-01-19,1712471,22097,1321922,16434,390549,5663,1484501,10304867,11789368,38897,69,21783,2077,169063,19951,1521625,121,45927,22709,79
88,2022-01-18,1690374,16232,1305488,10496,384886,5736,1467180,10283291,11750471,25008,97,21714,-5510,166986,21645,1501674,117,45806,22630,79
89,2022-01-17,1674142,11010,1294992,7460,379150,3550,1456223,10269240,11725463,19309,13,21617,-8092,172496,19089,1480029,92,45689,22551,70
90,2022-01-16,1663132,11555,1287532,9746,375600,1809,1448429,10257725,11706154,27488,21,21604,3696,180588,7838,1460940,67,45597,22481,63
91,2022-01-15,1651577,14892,1277786,11775,373791,3117,1437852,10240814,11678666,31283,18,21583,9194,176892,5680,1453102,90,45530,22418,60
92,2022-01-14,1636685,20157,1266011,15206,370674,4951,1425042,10222341,11647383,37759,199,21565,11330,167698,8628,1447422,110,45440,22358,86
93,2022-01-13,1616528,21098,1250805,15642,365723,5456,1408892,10200732,11609624,40404,175,21366,5316,156368,15607,1438794,137,45330,22272,54
94,2022-01-12,1595430,16998,1235163,12106,360267,4892,1392132,10177088,11569220,32670,67,21191,900,151052,16031,1423187,109,45193,22218,62
95,2022-01-11,1578432,16929,1223057,12421,355375,4508,1379080,10157470,11536550,30702,46,21124,279,150152,16604,1407156,125,45084,22156,76
96,2022-01-10,1561503,13836,1210636,9074,350867,4762,1365999,10139849,11505848,23682,58,21078,-394,149873,14172,1390552,148,44959,22080,63
97,2022-01-09,1547667,9165,1201562,6900,346105,2265,1356300,10125866,11482166,19889,36,21020,3197,150267,5932,1376380,103,44811,22017,54
98,2022-01-08,1538502,11585,1194662,9698,343840,1887,1348723,10113554,11462277,27637,1,20984,9086,147070,2498,1370448,120,44708,21963,61
99,2022-01-07,1526917,13270,1184964,10552,341953,2718,1338037,10096603,11434640,27831,30,20983,8909,137984,4331,1367950,89,44588,21902,53
100,2022-01-06,1513647,19457,1174412,14353,339235,5104,1327662,10079147,11406809,38100,29,20953,12822,129075,6606,1363619,134,44499,21849,51
101,2022-01-05,1494190,17459,1160059,12730,334131,4729,1312279,10056430,11368709,31866,37,20924,11185,116253,6237,1357013,110,44365,21798,57
102,2022-01-04,1476731,15124,1147329,9744,329402,5380,1299054,10037789,11336843,27091,46,20887,9689,105068,5389,1350776,104,44255,21741,46
103,2022-01-03,1461607,9195,1137585,6972,324022,2223,1288912,10020840,11309752,18216,50,20841,4717,95379,4428,1345387,83,44151,21695,36
104,2022-01-02,1452412,7543,1130613,6203,321799,1340,1281771,10009765,11291536,18366,21,20791,5448,90662,2074,1340959,73,44068,21659,47
105,2022-01-01,1444869,7696,1124410,6996,320459,700,1274828,9998342,11273170,22693,0,20770,5586,85214,2110,1338885,74,43995,21612,24
106,2021-12-31,1437173,11280,1117414,8965,319759,2315,1267092,9983385,11250477,25941,1,20770,8742,79628,2537,1336775,95,43921,21588,47
107,2021-12-30,1425893,14632,1108449,11017,317444,3615,1257560,9966976,11224536,30313,29,20769,12178,70886,2425,1334238,111,43826,21541,44
108,2021-12-29,1411261,12688,1097432,9331,313829,3357,1246021,9948202,11194223,29724,75,20740,10308,58708,2305,1331813,103,43715,21497,37
109,2021-12-28,1398573,11440,1088101,7785,310472,3655,1235661,9928838,11164499,23800,38,20665,9238,48400,2164,1329508,90,43612,21460,37
110,2021-12-27,1387133,6334,1080316,4311,306817,2023,1227729,9912970,11140699,16369,124,20627,3800,39162,2410,1327344,81,43522,21423,31
111,2021-12-26,1380799,1420,1076005,1278,304794,142,1223353,9900977,11124330,6025,149,20503,2,35362,1269,1324934,39,43441,21392,31
112,2021-12-25,1379379,3896,1074727,3202,304652,694,1221931,9896374,11118305,13827,18,20354,2666,35360,1212,1323665,53,43402,21361,16
113,2021-12-24,1375483,4659,1071525,3494,303958,1165,1218447,9886031,11104478,18910,0,20336,3038,32694,1621,1322453,61,43349,21345,34
114,2021-12-23,1370824,5184,1068031,3970,302793,1214,1214269,9871299,11085568,20710,62,20336,3370,29656,1752,1320832,60,43288,21311,35
115,2021-12-22,1365640,5880,1064061,3916,301579,1964,1210045,9854813,11064858,21087,2116,20274,1981,26286,1783,1319080,99,43228,21276,28
116,2021-12-21,1359760,3606,1060145,2593,299615,1013,1205988,9837783,11043771,17162,68,18158,1724,24305,1814,1317297,54,43129,21248,19
117,2021-12-20,1356154,2867,1057552,1989,298602,878,1203224,9823385,11026609,14110,91,18090,682,22581,2094,1315483,61,43075,21229,26
118,2021-12-19,1353287,1427,1055563,1013,297724,414,1201180,9811319,11012499,9639,26,17999,136,21899,1265,1313389,30,43014,21203,26
119,2021-12-18,1351860,1924,1054550,1461,297310,463,1200069,9802791,11002860,14412,0,17973,626,21763,1298,1312124,49,42984,21177,28
120,2021-12-17,1349936,2345,1053089,1650,296847,695,1198356,9790092,10988448,17209,43,17973,508,21137,1794,1310826,61,42935,21149,30
121,2021-12-16,1347591,2426,1051439,1667,296152,759,1196567,9774672,10971239,17734,47,17930,512,20629,1867,1309032,54,42874,21119,39
122,2021-12-15,1345165,2253,1049772,1573,295393,680,1194754,9758751,10953505,18116,38,17883,190,20117,2025,1307165,44,42820,21080,27
123,2021-12-14,1342912,2144,1048199,1385,294713,759,1193038,9742351,10935389,16667,82,17845,-30,19927,2092,1305140,55,42776,21053,21
124,2021-12-13,1340768,1800,1046814,1191,293954,609,1191538,9727184,10918722,12862,49,17763,-610,19957,2361,1303048,39,42721,21032,21
125,2021-12-12,1338968,1008,1045623,599,293345,409,1190278,9715582,10905860,9912,20,17714,-266,20567,1254,1300687,30,42682,21011,20
126,2021-12-11,1337960,978,1045024,806,292936,172,1189571,9706377,10895948,11067,4,17694,-255,20833,1229,1299433,49,42652,20991,25
127,2021-12-10,1336982,1842,1044218,1293,292764,549,1188582,9696299,10884881,17083,16,17690,336,21088,1490,1298204,63,42603,20966,28
128,2021-12-09,1335140,2101,1042925,1469,292215,632,1187176,9680622,10867798,17409,32,17674,1370,20752,699,1296714,57,42540,20938,29
129,2021-12-08,1333039,2525,1041456,1447,291583,1078,1185589,9664800,10850389,18246,18,17642,1115,19382,1392,1296015,61,42483,20909,35
130,2021-12-07,1330514,2155,1040009,1411,290505,744,1184051,9648092,10832143,14883,26,17624,720,18267,1409,1294623,62,42422,20874,17
131,2021-12-06,1328359,2011,1038598,1341,289761,670,1182551,9634709,10817260,13355,162,17598,205,17547,1644,1293214,59,42360,20857,24
132,2021-12-05,1326348,945,1037257,565,289091,380,1181014,9622891,10803905,7106,45,17436,22,17342,878,1291570,34,42301,20833,26
133,2021-12-04,1325403,1046,1036692,876,288711,170,1180407,9616392,10796799,11975,2,17391,151,17320,893,1290692,45,42267,20807,27
134,2021-12-03,1324357,2259,1035816,1671,288541,588,1179412,9605412,10784824,19206,41,17389,1013,17169,1205,1289799,56,42222,20780,23
135,2021-12-02,1322098,2154,1034145,1543,287953,611,1177621,9587997,10765618,18277,103,17348,649,16156,1402,1288594,38,42166,20757,30
136,2021-12-01,1319944,2427,1032602,1727,287342,700,1175870,9571471,10747341,21439,99,17245,1003,15507,1325,1287192,61,42128,20727,31
137,2021-11-30,1317517,2132,1030875,1361,286642,771,1174039,9551863,10725902,15148,152,17146,601,14504,1379,1285867,47,42067,20696,26
138,2021-11-29,1315385,2164,1029514,1367,285871,797,1172618,9538136,10710754,14095,43,16994,561,13903,1560,1284488,68,42020,20670,18
139,2021-11-28,1313221,705,1028147,458,285074,247,1171188,9525471,10696659,5746,17,16951,-212,13342,900,1282928,32,41952,20652,23
140,2021-11-27,1312516,699,1027689,577,284827,122,1170671,9520242,10690913,6680,0,16934,-169,13554,868,1282028,27,41920,20629,25
141,2021-11-26,1311817,520,1027112,465,284705,55,1170023,9514210,10684233,5523,2,16934,-749,13723,1267,1281160,23,41893,20604,17
142,2021-11-25,1311297,799,1026647,457,284650,342,1169464,9509246,10678710,7245,3,16932,-421,14472,1217,1279893,21,41870,20587,19
143,2021-11-24,1310498,1554,1026190,1112,284308,442,1168963,9502502,10671465,13704,12,16929,310,14893,1232,1278676,36,41849,20568,18
144,2021-11-23,1308944,1646,1025078,1129,283866,517,1167722,9490039,10657761,13387,50,16917,374,14583,1222,1277444,38,41813,20550,15
145,2021-11-22,1307298,1494,1023949,985,283349,509,1166496,9477878,10644374,13230,55,16867,-36,14209,1475,1276222,55,41775,20535,12
146,2021-11-21,1305804,581,1022964,350,282840,231,1165416,9465728,10631144,6664,14,16812,-206,14245,773,1274747,18,41720,20523,21
147,2021-11-20,1305223,841,1022614,669,282609,172,1165026,9459454,10624480,11042,0,16798,126,14451,715,1273974,25,41702,20502,19
148,2021-11-19,1304382,1557,1021945,1120,282437,437,1164259,9449179,10613438,17756,18,16798,493,14325,1046,1273259,31,41677,20483,19
149,2021-11-18,1302825,1609,1020825,1095,282000,514,1163050,9432632,10595682,22906,32,16780,490,13832,1087,1272213,39,41646,20464,21
150,2021-11-17,1301216,1806,1019730,1266,281486,540,1161708,9411068,10572776,22573,8,16748,800,13342,998,1271126,44,41607,20443,30
151,2021-11-16,1299410,1637,1018464,1082,280946,555,1160272,9389931,10550203,14603,49,16740,466,12542,1122,1270128,44,41563,20413,26
152,2021-11-15,1297773,1317,1017382,698,280391,619,1159113,9376487,10535600,9089,57,16691,-68,12076,1328,1269006,27,41519,20387,16
153,2021-11-14,1296456,712,1016684,615,279772,97,1158396,9368115,10526511,8946,4,16634,41,12144,667,1267678,23,41492,20371,13
154,2021-11-13,1295744,739,1016069,480,279675,259,1157710,9359855,10517565,9527,3,16630,4,12103,732,1267011,27,41469,20358,21
155,2021-11-12,1295005,1188,1015589,794,279416,394,1157182,9350856,10508038,14125,8,16627,300,12099,880,1266279,44,41442,20337,26
156,2021-11-11,1293817,1194,1014795,860,279022,334,1156327,9337586,10493913,16371,12,16619,161,11799,1021,1265399,28,41398,20311,25
157,2021-11-10,1292623,1474,1013935,1040,278688,434,1155383,9322159,10477542,18943,27,16607,383,11638,1064,1264378,57,41370,20286,28
158,2021-11-09,1291149,1942,1012895,1312,278254,630,1154226,9304373,10458599,20243,28,16580,852,11255,1062,1263314,48,41313,20258,30
159,2021-11-08,1289207,1147,1011583,730,277624,417,1152657,9285699,10438356,11106,45,16552,-214,10403,1316,1262252,45,41265,20228,25
160,2021-11-07,1288060,549,1010853,379,277207,170,1151844,9275406,10427250,7788,10,16507,-173,10617,712,1260936,25,41220,20203,24
161,2021-11-06,1287511,658,1010474,474,277037,184,1151402,9268060,10419462,10298,1,16497,-41,10790,698,1260224,24,41195,20179,18
162,2021-11-05,1286853,1108,1010000,748,276853,360,1150856,9258308,10409164,14195,35,16496,51,10831,1022,1259526,26,41171,20161,17
163,2021-11-04,1285745,952,1009252,702,276493,250,1150025,9244944,10394969,14096,29,16461,-239,10780,1162,1258504,22,41145,20144,26
164,2021-11-03,1284793,1268,1008550,834,276243,434,1149261,9231612,10380873,17485,32,16432,27,11019,1209,1257342,33,41123,20118,22
165,2021-11-02,1283525,1119,1007716,650,275809,469,1148343,9215045,10363388,10921,42,16400,-268,10992,1345,1256133,35,41090,20096,43
166,2021-11-01,1282406,1267,1007066,769,275340,498,1147630,9204837,10352467,10498,32,16358,-457,11260,1692,1254788,39,41055,20053,18
167,2021-10-31,1281139,438,1006297,334,274842,104,1146787,9195182,10341969,6261,0,16326,-442,11717,880,1253096,16,41016,20035,17
168,2021-10-30,1280701,634,1005963,511,274738,123,1146405,9189303,10335708,10104,8,16326,-347,12159,973,1252216,28,41000,20018,28
169,2021-10-29,1280067,1121,1005452,709,274615,412,1145790,9179814,10325604,14062,17,16318,-313,12506,1417,1251243,27,40972,19990,33
170,2021-10-28,1278946,1085,1004743,726,274203,359,1144977,9166565,10311542,13130,29,16301,-483,12819,1539,1249826,30,40945,19957,34
171,2021-10-27,1277861,1421,1004017,936,273844,485,1144134,9154278,10298412,18536,28,16272,-203,13302,1596,1248287,30,40915,19923,43
172,2021-10-26,1276440,1241,1003081,815,273359,426,1143111,9136765,10279876,12057,51,16244,-550,13505,1740,1246691,52,40885,19880,28
173,2021-10-25,1275199,1027,1002266,630,272933,397,1142195,9125624,10267819,12303,61,16193,-1121,14055,2087,1244951,46,40833,19852,31
174,2021-10-24,1274172,588,1001636,409,272536,179,1141487,9114029,10255516,7252,8,16132,-638,15176,1218,1242864,31,40787,19821,33
175,2021-10-23,1273584,792,1001227,560,272357,232,1140998,9107266,10248264,8478,0,16124,-491,15814,1283,1241646,29,40756,19788,39
176,2021-10-22,1272792,1337,1000667,899,272125,438,1140338,9099448,10239786,14266,16,16124,-581,16305,1902,1240363,43,40727,19749,42
177,2021-10-21,1271455,1695,999768,1264,271687,431,1139303,9086217,10225520,19146,54,16108,-455,16886,2096,1238461,53,40684,19707,56
178,2021-10-20,1269760,1636,998504,1094,271256,542,1137884,9068490,10206374,16008,52,16054,-625,17341,2209,1236365,39,40631,19651,46
179,2021-10-19,1268124,1893,997410,1030,270714,863,1136629,9053737,10190366,13860,79,16002,-798,17966,2612,1234156,45,40592,19605,33
180,2021-10-18,1266231,1600,996380,998,269851,602,1135445,9041061,10176506,11609,86,15923,-1530,18764,3044,1231544,70,40547,19572,52
181,2021-10-17,1264631,578,995382,493,269249,85,1134318,9030579,10164897,6348,7,15837,-948,20294,1519,1228500,38,40477,19520,42
182,2021-10-16,1264053,842,994889,689,269164,153,1133728,9024821,10158549,8933,20,15830,-798,21242,1620,1226981,36,40439,19478,49
183,2021-10-15,1263211,1780,994200,1204,269011,576,1132909,9016707,10149616,13892,33,15810,-898,22040,2645,1225361,60,40403,19429,42
184,2021-10-14,1261431,2055,992996,1457,268435,598,1131525,9004199,10135724,15482,59,15777,-862,22938,2858,1222716,63,40343,19387,62
185,2021-10-13,1259376,2084,991539,1489,267837,595,1129845,8990397,10120242,15483,35,15718,-996,23800,3045,1219858,66,40280,19325,53
186,2021-10-12,1257292,2249,990050,1496,267242,753,1128117,8976642,10104759,14673,47,15683,-1084,24796,3286,1216813,70,40214,19272,69
187,2021-10-11,1255043,2607,988554,1221,266489,1386,1126073,8964013,10090086,12278,104,15636,-1486,25880,3989,1213527,70,40144,19203,46
188,2021-10-10,1252436,799,987333,703,265103,96,1124693,8953115,10077808,8812,8,15532,-1176,27366,1967,1209538,39,40074,19157,46
189,2021-10-09,1251637,1391,986630,999,265007,392,1123830,8945166,10068996,12296,4,15524,-621,28542,2008,1207571,63,40035,19111,67
190,2021-10-08,1250246,2368,985631,1492,264615,876,1122606,8934094,10056700,17550,17,15520,-570,29163,2921,1205563,74,39972,19044,61
191,2021-10-07,1247878,2518,984139,1762,263739,756,1120873,8918277,10039150,20203,52,15503,-1158,29733,3624,1202642,56,39898,18983,63
192,2021-10-06,1245360,2449,982377,1916,262983,533,1118883,8900064,10018947,21328,61,15451,-1330,30891,3718,1199018,68,39842,18920,79
193,2021-10-05,1242911,3086,980461,1943,262450,1143,1116655,8880964,9997619,17569,41,15390,-1302,32221,4347,1195300,84,39774,18841,90
194,2021-10-04,1239825,3115,978518,1931,261307,1184,1114522,8865528,9980050,17475,81,15349,-2087,33523,5121,1190953,76,39690,18751,65
195,2021-10-03,1236710,1169,976587,1013,260123,156,1112339,8850236,9962575,9987,35,15268,-1039,35610,2173,1185832,36,39614,18686,70
196,2021-10-02,1235541,1643,975574,1184,259967,459,1111136,8841452,9952588,14506,29,15233,-877,36649,2491,1183659,52,39578,18616,73
197,2021-10-01,1233898,3450,974390,2481,259508,969,1109706,8828376,9938082,21511,54,15204,-786,37526,4182,1181168,100,39526,18543,73
198,2021-09-30,1230448,3303,971909,2205,258539,1098,1106891,8809680,9916571,22306,56,15150,-1635,38312,4882,1176986,81,39426,18470,87
199,2021-09-29,1227145,4125,969704,2817,257441,1308,1104396,8789869,9894265,25273,50,15094,-1049,39947,5124,1172104,110,39345,18383,93
200,2021-09-28,1223020,3584,966887,2283,256133,1301,1101165,8767827,9868992,16384,44,15044,-2415,40996,5955,1166980,82,39235,18290,74
201,2021-09-27,1219436,3338,964604,1957,254832,1381,1098560,8754048,9852608,14424,101,15000,-4169,43411,7406,1161025,99,39153,18216,96
202,2021-09-26,1216098,2125,962647,1662,253451,463,1096368,8741816,9838184,17988,18,14899,-987,47580,3094,1153619,59,39054,18120,87
203,2021-09-25,1213973,1869,960985,1454,252988,415,1094363,8725833,9820196,12237,34,14881,-1896,48567,3731,1150525,48,38995,18033,88
204,2021-09-24,1212104,3879,959531,2683,252573,1196,1092638,8715321,9807959,23960,75,14847,-2436,50463,6240,1146794,101,38947,17945,101
205,2021-09-23,1208225,5560,956848,3879,251377,1681,1089544,8694455,9783999,27644,85,14772,-1678,52899,7153,1140554,130,38846,17844,110
206,2021-09-22,1202665,4079,952969,2866,249696,1213,1085128,8671227,9756355,23281,63,14687,-3734,54577,7750,1133401,107,38716,17734,110
207,2021-09-21,1198586,4706,950103,2997,248483,1709,1081915,8651159,9733074,20491,95,14624,-5296,58311,9907,1125651,159,38609,17624,127
208,2021-09-20,1193880,4616,947106,2824,246774,1792,1078535,8634048,9712583,21163,131,14529,72,63607,4413,1115744,182,38450,17497,105
209,2021-09-19,1189264,1665,944282,1219,244982,446,1075317,8616103,9691420,10544,38,14398,-2481,63535,4108,1111331,74,38268,17392,103
210,2021-09-18,1187599,3979,943063,3165,244536,814,1073871,8607005,9680876,23488,14,14360,-401,66016,4366,1107223,119,38194,17289,111
211,2021-09-17,1183620,6757,939898,4787,243722,1970,1070128,8587260,9657388,32873,57,14346,-391,66417,7091,1102857,189,38075,17178,118
212,2021-09-16,1176863,6321,935111,4625,241752,1696,1064753,8559762,9624515,28348,52,14289,-1873,66808,8142,1095766,148,37886,17060,96
213,2021-09-15,1170542,4527,930486,2949,240056,1578,1059642,8536525,9596167,16933,64,14237,-4442,68681,8905,1087624,107,37738,16964,102
214,2021-09-14,1166015,7367,927537,5056,238478,2311,1056461,8522773,9579234,28343,87,14173,-2376,73123,9656,1078719,168,37631,16862,108
215,2021-09-13,1158648,5604,922481,3389,236167,2215,1050849,8500042,9550891,19986,128,14086,-5953,75499,11429,1069063,205,37463,16754,129
216,2021-09-12,1153044,3442,919092,2907,233952,535,1047188,8483717,9530905,18657,34,13958,-850,81452,4258,1057634,125,37258,16625,97
217,2021-09-11,1149602,11292,916185,8207,233417,3085,1043895,8468353,9512248,50053,28,13924,6532,82302,4732,1053376,282,37133,16528,107
218,2021-09-10,1138310,15072,907978,10734,230332,4338,1034748,8427447,9462195,59841,58,13896,6579,75770,8435,1048644,348,36851,16421,96
219,2021-09-09,1123238,5165,897244,2873,225994,2292,1022944,8379410,9402354,16925,12,13838,-4358,69191,9511,1040209,124,36503,16325,103
220,2021-09-08,1118073,4472,894371,3214,223702,1258,1019831,8365598,9385429,16630,73,13826,-5047,73549,9446,1030698,154,36379,16222,115
221,2021-09-07,1113601,5340,891157,3663,222444,1677,1016293,8352506,9368799,18946,84,13753,-5384,78596,10640,1021252,156,36225,16107,96
222,2021-09-06,1108261,13049,887494,10470,220767,2579,1012320,8337533,9349853,64001,24,13669,2175,83980,10850,1010612,254,36069,16011,98
223,2021-09-05,1095212,11381,877024,8095,218188,3286,1000625,8285227,9285852,50013,11,13645,6952,81805,4418,999762,138,35815,15913,116
224,2021-09-04,1083831,9057,868929,6590,214902,2467,991752,8244087,9235839,39221,14,13634,4230,74853,4813,995344,153,35677,15797,95
225,2021-09-03,1074774,4791,862339,3363,212435,1428,984423,8212195,9196618,16831,42,13620,-3145,70623,7894,990531,90,35524,15702,89
226,2021-09-02,1069983,6552,858976,4323,211007,2229,980761,8199026,9179787,21717,75,13578,-1830,73768,8307,982637,120,35434,15613,87
227,2021-09-01,1063431,3277,854653,2094,208778,1183,976108,8181962,9158070,8664,35,13503,-4013,75598,7255,974330,81,35314,15526,93
228,2021-08-31,1060154,9412,852559,6238,207595,3174,973952,8175454,9149406,35311,32,13468,1139,79611,8241,967075,236,35233,15433,98
229,2021-08-30,1050742,9855,846321,7499,204421,2356,967108,8146987,9114095,43400,57,13436,1674,78472,8124,958834,195,34997,15335,95
230,2021-08-29,1040887,6410,838822,5200,202065,1210,958786,8111909,9070695,30263,21,13379,3075,76798,3314,950710,144,34802,15240,78
231,2021-08-28,1034477,6177,833622,4443,200855,1734,953022,8087410,9040432,25319,16,13358,2733,73723,3428,947396,122,34658,15162,83
232,2021-08-27,1028300,7838,829179,6070,199121,1768,948167,8066946,9015113,31856,51,13342,2720,70990,5067,943968,135,34536,15079,74
233,2021-08-26,1020462,7464,823109,5038,197353,2426,941690,8041567,8983257,30166,40,13291,1735,68270,5689,938901,132,34401,15005,70
234,2021-08-25,1012998,6570,818071,3819,194927,2751,936245,8016846,8953091,20753,49,13251,1326,66535,5195,933212,123,34269,14935,84
235,2021-08-24,1006428,4575,814252,3145,192176,1430,932236,8000102,8932338,15482,23,13202,-1051,65209,5603,928017,85,34146,14851,87
236,2021-08-23,1001853,5144,811107,2924,190746,2220,928897,7987959,8916856,15844,31,13179,-465,66260,5578,922414,106,34061,14764,59
237,2021-08-22,996709,4050,808183,3768,188526,282,925779,7975233,8901012,23264,25,13148,1341,66725,2684,916836,63,33955,14705,64
238,2021-08-21,992659,9797,804415,6888,188244,2909,921516,7956232,8877748,42183,12,13123,7267,65384,2518,914152,142,33892,14641,58
239,2021-08-20,982862,6379,797527,5028,185335,1351,914041,7921524,8835565,27845,26,13111,2671,58117,3682,911634,110,33750,14583,73
240,2021-08-19,976483,7126,792499,4562,183984,2564,908700,7899020,8807720,32003,45,13085,2983,55446,4098,907952,103,33640,14510,57
241,2021-08-18,969357,6508,787937,4424,181420,2084,903820,7871897,8775717,27192,51,13040,2737,52463,3720,903854,94,33537,14453,55
242,2021-08-17,962849,5400,783513,3950,179336,1450,898972,7849553,8748525,24057,27,12989,1472,49726,3901,900134,76,33443,14398,50
243,2021-08-16,957449,3700,779563,2317,177886,1383,894605,7829863,8724468,13976,32,12962,-113,48254,3781,896233,76,33367,14348,44
244,2021-08-15,953749,2777,777246,2309,176503,468,892064,7818428,8710492,14043,19,12930,647,48367,2111,892452,47,33291,14304,43
245,2021-08-14,950972,4859,774937,3683,176035,1176,889439,7807010,8696449,24152,4,12911,2855,47720,2000,890341,78,33244,14261,45
246,2021-08-13,946113,5539,771254,4011,174859,1528,885289,7787008,8672297,25866,22,12907,2801,44865,2716,888341,90,33166,14216,61
247,2021-08-12,940574,4593,767243,3518,173331,1075,880911,7765520,8646431,22110,29,12885,1802,42064,2762,885625,125,33076,14155,37
248,2021-08-11,935981,5602,763725,3972,172256,1630,877017,7747304,8624321,25854,20,12856,2937,40262,2645,882863,172,32951,14118,44
249,2021-08-10,930379,4088,759753,2634,170626,1454,872734,7725733,8598467,16272,7,12836,1525,37325,2556,880218,120,32779,14074,33
250,2021-08-09,926291,3639,757119,2371,169172,1268,869846,7712349,8582195,13615,40,12829,1082,35800,2517,877662,144,32659,14041,40
251,2021-08-08,922652,2159,754748,1608,167904,551,867285,7701295,8568580,11103,6,12789,782,34718,1371,875145,84,32515,14001,37
252,2021-08-07,920493,2590,753140,2003,167353,587,865435,7692042,8557477,14489,3,12783,1227,33936,1360,873774,94,32431,13964,25
253,2021-08-06,917903,4528,751137,3268,166766,1260,863151,7679837,8542988,21573,8,12780,2894,32709,1626,872414,152,32337,13939,39
254,2021-08-05,913375,3914,747869,2962,165506,952,859568,7661847,8521415,20131,29,12772,2292,29815,1593,870788,121,32185,13900,17
255,2021-08-04,909461,3243,744907,2525,164554,718,856320,7644964,8501284,17670,15,12743,1724,27523,1504,869195,129,32064,13883,17
256,2021-08-03,906218,3746,742382,2651,163836,1095,853534,7630080,8483614,17466,9,12728,2350,25799,1387,867691,124,31935,13866,22
257,2021-08-02,902472,2694,739731,1816,162741,878,850675,7615473,8466148,11333,17,12719,1277,23449,1400,866304,118,31811,13844,21
258,2021-08-01,899778,1690,737915,1348,161863,342,848738,7606077,8454815,9802,8,12702,929,22172,753,864904,78,31693,13823,12
259,2021-07-31,898088,2033,736567,1524,161521,509,847225,7597788,8445013,11003,9,12694,1293,21243,731,864151,98,31615,13811,17
260,2021-07-30,896055,3095,735043,2417,161012,678,845529,7588481,8434010,16383,8,12685,2252,19950,835,863420,119,31517,13794,10
261,2021-07-29,892960,2307,732626,1650,160334,657,842911,7574716,8417627,12930,2,12677,1533,17698,772,862585,76,31398,13784,14
262,2021-07-28,890653,2664,730976,1912,159677,752,841158,7563539,8404697,14871,8,12675,1823,16165,833,861813,100,31322,13770,13
263,2021-07-27,887989,2267,729064,1492,158925,775,839091,7550735,8389826,11495,12,12667,1530,14342,725,860980,82,31222,13757,16
264,2021-07-26,885722,2138,727572,1394,158150,744,837495,7540836,8378331,9570,20,12655,1371,12812,747,860255,113,31140,13741,13
265,2021-07-25,883584,864,726178,722,157406,142,836027,7532734,8368761,6235,11,12635,396,11441,457,859508,32,31027,13728,10
266,2021-07-24,882720,1267,725456,931,157264,336,835235,7527291,8362526,8408,4,12624,769,11045,494,859051,66,30995,13718,10
267,2021-07-23,881453,1556,724525,1108,156928,448,834213,7519905,8354118,10506,4,12620,1036,10276,516,858557,73,30929,13708,21
268,2021-07-22,879897,1541,723417,1097,156480,444,833039,7510573,8343612,11777,7,12616,1003,9240,531,858041,67,30856,13687,8
269,2021-07-21,878356,1446,722320,1022,156036,424,831824,7500011,8331835,10143,15,12609,875,8237,556,857510,74,30789,13679,12
270,2021-07-20,876910,1280,721298,898,155612,382,830765,7490927,8321692,10009,4,12594,772,7362,504,856954,61,30715,13667,9
271,2021-07-19,875630,973,720400,632,155230,341,829781,7481902,8311683,7033,8,12590,536,6590,429,856450,50,30654,13658,6
272,2021-07-18,874657,477,719768,368,154889,109,829106,7475544,8304650,4715,1,12582,201,6054,275,856021,23,30604,13652,9
273,2021-07-17,874180,623,719400,449,154780,174,828688,7471247,8299935,6028,2,12581,282,5853,339,855746,37,30581,13643,3
274,2021-07-16,873557,784,718951,563,154606,221,828188,7465719,8293907,7977,2,12579,480,5571,302,855407,54,30544,13640,7
275,2021-07-15,872773,791,718388,575,154385,216,827583,7458347,8285930,8704,6,12577,449,5091,336,855105,43,30490,13633,5
276,2021-07-14,871982,710,717813,533,154169,177,826967,7450259,8277226,8714,4,12571,429,4642,277,854769,29,30447,13628,3
277,2021-07-13,871272,806,717280,521,153992,285,826414,7442098,8268512,8126,8,12567,526,4213,272,854492,52,30418,13625,10
278,2021-07-12,870466,583,716759,384,153707,199,825860,7434526,8260386,5753,10,12559,287,3687,286,854220,30,30366,13615,6
279,2021-07-11,869883,230,716375,200,153508,30,825455,7429178,8254633,3563,8,12549,58,3400,164,853934,27,30336,13609,4
280,2021-07-10,869653,408,716175,297,153478,111,825214,7425856,8251070,5364,0,12541,255,3342,153,853770,30,30309,13605,6
281,2021-07-09,869245,564,715878,420,153367,144,824895,7420811,8245706,8277,5,12541,366,3087,193,853617,31,30279,13599,5
282,2021-07-08,868681,558,715458,410,153223,148,824451,7412978,8237429,8314,4,12536,375,2721,179,853424,19,30248,13594,3
283,2021-07-07,868123,501,715048,345,153075,156,824023,7405092,8229115,7939,8,12532,321,2346,172,853245,17,30229,13591,6
284,2021-07-06,867622,428,714703,285,152919,143,823653,7397523,8221176,5845,6,12524,224,2025,198,853073,19,30212,13585,5
285,2021-07-05,867194,191,714418,108,152776,83,823344,7391987,8215331,2627,1,12518,0,1801,190,852875,15,30193,13580,3
286,2021-07-04,867003,179,714310,138,152693,41,823224,7389480,8212704,3222,0,12517,61,1801,118,852685,7,30178,13577,3
287,2021-07-03,866824,267,714172,186,152652,81,823071,7386411,8209482,4827,3,12517,127,1740,137,852567,19,30171,13574,7
288,2021-07-02,866557,318,713986,218,152571,100,822860,7381795,8204655,6602,2,12514,168,1613,148,852430,13,30152,13567,4
289,2021-07-01,866239,303,713768,195,152471,108,822617,7375436,8198053,8126,3,12512,146,1445,154,852282,11,30139,13563,7
290,2021-06-30,865936,301,713573,227,152363,74,822383,7367544,8189927,7416,6,12509,132,1299,163,852128,17,30128,13556,5
291,2021-06-29,865635,412,713346,258,152289,154,822127,7360384,8182511,9323,-2,12503,261,1167,153,851965,18,30111,13551,4
292,2021-06-28,865223,110,713088,76,152135,34,821849,7351339,8173188,3391,7,12505,-86,906,189,851812,4,30093,13547,2
293,2021-06-27,865113,96,713012,63,152101,33,821766,7348031,8169797,3207,4,12498,-15,992,107,851623,3,30089,13545,4
294,2021-06-26,865017,129,712949,93,152068,36,821699,7344891,8166590,5479,3,12494,1,1007,125,851516,7,30086,13541,3
295,2021-06-25,864888,216,712856,158,152032,58,821598,7339513,8161111,7524,0,12491,85,1006,131,851391,12,30079,13538,7
296,2021-06-24,864672,221,712698,156,151974,65,821409,7332178,8153587,7654,7,12491,35,921,179,851260,21,30067,13531,5
297,2021-06-23,864451,230,712542,175,151909,55,821221,7324712,8145933,8707,4,12484,24,886,202,851081,13,30046,13526,7
298,2021-06-22,864221,235,712367,128,151854,107,821014,7316212,8137226,7449,5,12480,81,862,149,850879,16,30033,13519,5
299,2021-06-21,863986,155,712239,102,151747,53,820871,7308906,8129777,5767,10,12475,-81,781,226,850730,11,30017,13514,4
300,2021-06-20,863831,84,712137,65,151694,19,820729,7303281,8124010,3285,3,12465,-37,862,118,850504,5,30006,13510,5
301,2021-06-19,863747,127,712072,76,151675,51,820661,7300064,8120725,5545,3,12462,-54,899,178,850386,11,30001,13505,7
302,2021-06-18,863620,182,711996,141,151624,41,820566,7294614,8115180,7500,2,12459,-29,953,209,850208,11,29990,13498,8
303,2021-06-17,863438,169,711855,127,151583,42,820400,7287280,8107680,9334,3,12457,-51,982,217,849999,2,29979,13490,4
304,2021-06-16,863269,266,711728,210,151541,56,820246,7278100,8098346,9423,7,12454,29,1033,230,849782,11,29977,13486,6
305,2021-06-15,863003,307,711518,208,151485,99,820005,7268918,8088923,8673,2,12447,-39,1004,344,849552,11,29966,13480,9
306,2021-06-14,862696,214,711310,119,151386,95,819759,7260491,8080250,6455,5,12445,26,1043,183,849208,16,29955,13471,5
307,2021-06-13,862482,85,711191,69,151291,16,819605,7254190,8073795,3459,3,12440,-96,1017,178,849025,6,29939,13466,5
308,2021-06-12,862397,148,711122,94,151275,54,819515,7250821,8070336,5821,0,12437,-30,1113,178,848847,12,29933,13461,7
309,2021-06-11,862249,289,711028,156,151221,133,819401,7245114,8064515,7399,-2,12437,48,1143,243,848669,22,29921,13454,9
310,2021-06-10,861960,236,710872,172,151088,64,819215,7237901,8057116,8587,3,12439,-51,1095,284,848426,12,29899,13445,11
311,2021-06-09,861724,215,710700,154,151024,61,819008,7229521,8048529,10848,2,12436,-76,1146,289,848142,12,29887,13434,10
312,2021-06-08,861509,271,710546,181,150963,90,818813,7218868,8037681,7501,2,12434,-81,1222,350,847853,22,29875,13424,8
313,2021-06-07,861238,260,710365,153,150873,107,818611,7211569,8030180,6028,13,12432,-154,1303,401,847503,24,29853,13416,5
314,2021-06-06,860978,101,710212,80,150766,21,818405,7205747,8024152,4272,-1,12419,-146,1457,248,847102,8,29829,13411,5
315,2021-06-05,860877,164,710132,114,150745,50,818313,7201567,8019880,5971,3,12420,-165,1603,326,846854,13,29821,13406,10
316,2021-06-04,860713,294,710018,202,150695,92,818183,7195726,8013909,9694,0,12417,-96,1768,390,846528,15,29808,13396,6
317,2021-06-03,860419,317,709816,219,150603,98,817929,7186286,8004215,11728,4,12417,-107,1864,420,846138,21,29793,13390,10
318,2021-06-02,860102,362,709597,249,150505,113,817606,7174881,7992487,9573,7,12413,-88,1971,443,845718,23,29772,13380,11
319,2021-06-01,859740,420,709348,277,150392,143,817324,7165590,7982914,6863,9,12406,-61,2059,472,845275,31,29749,13369,8
320,2021-05-31,859320,187,709071,130,150249,57,817018,7159033,7976051,4044,10,12397,-369,2120,546,844803,12,29718,13361,12
321,2021-05-30,859133,180,708941,129,150192,51,816861,7155146,7972007,4773,0,12387,-209,2489,389,844257,15,29706,13349,14
322,2021-05-29,858953,188,708812,135,150141,53,816706,7150528,7967234,5758,2,12387,-249,2698,435,843868,20,29691,13335,5
323,2021-05-28,858765,317,708677,244,150088,73,816514,7144962,7961476,9595,3,12385,-162,2947,476,843433,17,29671,13330,10
324,2021-05-27,858448,393,708433,266,150015,127,816227,7135654,7951881,10621,13,12382,-231,3109,611,842957,24,29654,13320,11
325,2021-05-26,858055,497,708167,367,149888,130,815849,7125411,7941260,12267,23,12369,-113,3340,587,842346,39,29630,13309,13
326,2021-05-25,857558,420,707800,282,149758,138,815421,7113572,7928993,9200,6,12346,-198,3453,612,841759,27,29591,13296,15
327,2021-05-24,857138,450,707518,314,149620,136,815130,7104663,7919793,7768,7,12340,-296,3651,739,841147,30,29564,13281,10
328,2021-05-23,856688,251,707204,187,149484,64,814775,7097250,7912025,5363,6,12333,-273,3947,518,840408,17,29534,13271,10
329,2021-05-22,856437,309,707017,232,149420,77,814543,7092119,7906662,7446,3,12327,-170,4220,476,839890,26,29517,13261,9
330,2021-05-21,856128,516,706785,345,149343,171,814245,7084971,7899216,10298,3,12324,-127,4390,640,839414,23,29491,13252,12
331,2021-05-20,855612,545,706440,392,149172,153,813844,7075074,7888918,24048,16,12321,-207,4517,736,838774,33,29468,13240,17
332,2021-05-19,855067,630,706048,463,149019,167,813377,7051493,7864870,13912,11,12305,-158,4724,777,838038,40,29435,13223,14
333,2021-05-18,854437,569,705585,388,148852,181,812844,7038114,7850958,10683,14,12294,-270,4882,825,837261,37,29395,13209,15
334,2021-05-17,853868,652,705197,396,148671,256,812406,7027869,7840275,9113,12,12280,-317,5152,957,836436,29,29358,13194,17
335,2021-05-16,853216,274,704801,201,148415,73,811950,7019212,7831162,5278,4,12268,-302,5469,572,835479,19,29329,13177,11
336,2021-05-15,852942,403,704600,295,148342,108,811699,7014185,7825884,8538,1,12264,-242,5771,644,834907,23,29310,13166,11
337,2021-05-14,852539,803,704305,592,148234,211,811323,7006023,7817346,12108,10,12263,57,6013,736,834263,49,29287,13155,19
338,2021-05-13,851736,708,703713,481,148023,227,810645,6994593,7805238,12388,7,12253,-147,5956,848,833527,35,29238,13136,14
339,2021-05-12,851028,897,703232,653,147796,244,810097,6982753,7792850,17151,9,12246,-84,6103,972,832679,50,29203,13122,17
340,2021-05-11,850131,844,702579,614,147552,230,809300,6966399,7775699,11523,4,12237,-191,6187,1031,831707,46,29153,13105,14
341,2021-05-10,849287,625,701965,383,147322,242,808646,6955530,7764176,7511,17,12233,-632,6378,1240,830676,57,29107,13091,16
342,2021-05-09,848662,376,701582,284,147080,92,808213,6948452,7756665,6853,18,12216,-363,7010,721,829436,26,29050,13075,17
343,2021-05-08,848286,559,701298,400,146988,159,807878,6941934,7749812,10158,0,12198,-101,7373,660,828715,28,29024,13058,18
344,2021-05-07,847727,1029,700898,743,146829,286,807382,6932272,7739654,15079,2,12198,62,7474,965,828055,50,28996,13040,15
345,2021-05-06,846698,786,700155,548,146543,238,806529,6918046,7724575,11569,11,12196,-285,7412,1060,827090,36,28946,13025,17
346,2021-05-05,845912,1205,699607,768,146305,437,805893,6907113,7713006,17608,16,12185,240,7697,949,826030,50,28910,13008,15
347,2021-05-04,844707,851,698839,604,145868,247,805026,6890372,7695398,12118,11,12169,-259,7457,1099,825081,40,28860,12993,16
348,2021-05-03,843856,657,698235,455,145621,202,804335,6878945,7683280,8324,13,12158,-546,7716,1190,823982,42,28820,12977,14
349,2021-05-02,843199,499,697780,376,145419,123,803812,6871144,7674956,7405,1,12145,-217,8262,715,822792,28,28778,12963,16
350,2021-05-01,842700,608,697404,448,145296,160,803372,6864179,7667551,10380,-1,12144,-169,8479,778,822077,36,28750,12947,13
351,2021-04-30,842092,1071,696956,773,145136,298,802885,6854286,7657171,14992,7,12145,23,8648,1041,821299,42,28714,12934,18
352,2021-04-29,841021,1025,696183,689,144838,336,802017,6840162,7642179,14642,9,12138,-48,8625,1064,820258,50,28672,12916,18
353,2021-04-28,839996,1191,695494,862,144502,329,801236,6826301,7627537,20549,17,12129,-14,8673,1188,819194,67,28622,12898,16
354,2021-04-27,838805,1154,694632,710,144173,444,800240,6806748,7606988,13762,8,12112,-44,8687,1190,818006,64,28555,12882,17
355,2021-04-26,837651,1093,693922,719,143729,374,799442,6793784,7593226,9828,11,12104,-365,8731,1447,816816,48,28491,12865,20
356,2021-04-25,836558,553,693203,426,143355,127,798662,6784736,7583398,8195,6,12093,-287,9096,834,815369,37,28443,12845,14
357,2021-04-24,836005,751,692777,568,143228,183,798162,6777041,7575203,13084,0,12087,-213,9383,964,814535,53,28406,12831,14
358,2021-04-23,835254,947,692209,690,143045,257,797507,6764612,7562119,14910,4,12087,-220,9596,1163,813571,44,28353,12817,17
359,2021-04-22,834307,1843,691519,1049,142788,794,796673,6750536,7547209,22058,12,12083,603,9816,1228,812408,74,28309,12800,17
360,2021-04-21,832464,1380,690470,947,141994,433,795492,6729659,7525151,17935,18,12071,95,9213,1267,811180,60,28235,12783,19
361,2021-04-20,831084,1093,689523,901,141561,192,794439,6712777,7507216,13963,15,12053,-244,9118,1322,809913,72,28175,12764,14
362,2021-04-19,829991,838,688622,550,141369,288,793469,6699784,7493253,9226,15,12038,-652,9362,1475,808591,50,28103,12750,22
363,2021-04-18,829153,560,688072,478,141081,82,792859,6691168,7484027,8182,17,12023,-258,10014,801,807116,27,28053,12728,17
364,2021-04-17,828593,704,687594,573,140999,131,792293,6683552,7475845,11841,1,12006,-94,10272,797,806315,38,28026,12711,15
365,2021-04-16,827889,4201,687021,3988,140868,213,791617,6672387,7464004,35381,14,12005,3218,10366,969,805518,72,27988,12696,11
366,2021-04-15,823688,1378,683033,1002,140655,376,786994,6641629,7428623,18249,8,11991,184,7148,1186,804549,61,27916,12685,14
367,2021-04-14,822310,1795,682031,1336,140279,459,785900,6624474,7410374,24887,9,11983,651,6964,1135,803363,80,27855,12671,15
368,2021-04-13,820515,1128,680695,705,139820,423,784388,6601099,7385487,10996,10,11974,-100,6313,1218,802228,60,27775,12656,17
369,2021-04-12,819387,1234,679990,884,139397,350,783629,6590862,7374491,9294,7,11964,-76,6413,1303,801010,59,27715,12639,23
370,2021-04-11,818153,652,679106,460,139047,192,782652,6582545,7365197,7622,3,11957,-228,6489,877,799707,40,27656,12616,8
371,2021-04-10,817501,873,678646,607,138855,266,782139,6575436,7357575,12129,8,11954,46,6717,819,798830,59,27616,12608,15
372,2021-04-09,816628,1339,678039,1048,138589,291,781439,6564007,7345446,16591,3,11946,242,6671,1094,798011,75,27557,12593,24
373,2021-04-08,815289,1144,676991,779,138298,365,780255,6548600,7328855,15098,4,11943,-41,6429,1181,796917,58,27482,12569,11
374,2021-04-07,814145,1577,676212,1185,137933,392,779358,6534399,7313757,21195,21,11939,311,6470,1245,795736,77,27424,12558,17
375,2021-04-06,812568,1336,675027,886,137541,450,778069,6514493,7292562,14514,8,11918,55,6159,1273,794491,73,27347,12541,13
376,2021-04-05,811232,890,674141,518,137091,372,777077,6500971,7278048,6203,38,11910,-563,6104,1415,793218,73,27274,12528,18
377,2021-04-04,810342,552,673623,417,136719,135,776517,6495328,7271845,9632,7,11872,-296,6667,841,791803,33,27201,12510,25
378,2021-04-03,809790,893,673206,639,136584,254,776020,6486193,7262213,10440,0,11865,-26,6963,919,790962,34,27168,12485,20
379,2021-04-02,808897,1061,672567,809,136330,252,775301,6476472,7251773,14095,2,11865,-49,6989,1108,790043,45,27134,12465,13
380,2021-04-01,807836,1250,671758,906,136078,344,774360,6463318,7237678,14430,6,11863,-112,7038,1356,788935,49,27089,12452,20
381,2021-03-31,806586,1866,670852,1201,135734,665,773358,6449890,7223248,22673,11,11857,568,7150,1287,787579,60,27040,12432,20
382,2021-03-30,804720,1192,669651,879,135069,313,772002,6428573,7200575,14264,10,11846,-125,6582,1307,786292,66,26980,12412,16
383,2021-03-29,803528,1191,668772,621,134756,570,770988,6415323,7186311,8741,29,11836,-262,6707,1424,784985,49,26914,12396,12
384,2021-03-28,802337,814,668151,568,134186,246,770284,6407286,7177570,10847,12,11807,-117,6969,919,783561,40,26865,12384,10
385,2021-03-27,801523,815,667583,746,133940,69,769622,6397101,7166723,12899,11,11795,-55,7086,859,782642,39,26825,12374,20
386,2021-03-26,800708,995,666837,799,133871,196,768753,6385071,7153824,11800,25,11784,-320,7141,1290,781783,41,26786,12354,26
387,2021-03-25,799713,1144,666038,869,133675,275,767849,6374175,7142024,16421,20,11759,-195,7461,1319,780493,49,26745,12328,14
388,2021-03-24,798569,1608,665169,1281,133400,327,766857,6358746,7125603,21263,4,11739,281,7656,1323,779174,59,26696,12314,11
389,2021-03-23,796961,1171,663888,727,133073,444,765460,6338880,7104340,14736,44,11735,-181,7375,1308,777851,45,26637,12303,14
390,2021-03-22,795790,1267,663161,813,132629,454,764619,6324985,7089604,9624,34,11691,-111,7556,1344,776543,53,26592,12289,15
391,2021-03-21,794523,757,662348,566,132175,191,763723,6316257,7079980,8778,-48,11657,16,7667,789,775199,22,26539,12274,17
392,2021-03-20,793766,750,661782,516,131984,234,763072,6308130,7071202,9859,4,11705,-55,7651,801,774410,24,26517,12257,10
393,2021-03-19,793016,1942,661266,1292,131750,650,762478,6298865,7061343,22150,28,11701,749,7706,1165,773609,66,26493,12247,16
394,2021-03-18,791074,1414,659974,973,131100,441,761051,6278142,7039193,18473,23,11673,261,6957,1130,772444,57,26427,12231,18
395,2021-03-17,789660,1069,659001,825,130659,244,759943,6260777,7020720,15727,8,11650,-83,6696,1144,771314,50,26370,12213,21
396,2021-03-16,788591,1930,658176,1249,130415,681,759019,6245974,7004993,18970,12,11642,716,6779,1202,770170,83,26320,12192,11
397,2021-03-15,786661,901,656927,504,129734,397,757592,6228431,6986023,5319,11,11630,-260,6063,1150,768968,40,26237,12181,9
398,2021-03-14,785760,661,656423,459,129337,202,757032,6223672,6980704,7935,0,11619,-103,6323,764,767818,25,26197,12172,19
399,2021-03-13,785099,1482,655964,800,129135,682,756491,6216278,6972769,16708,-12,11619,600,6426,894,767054,48,26172,12153,14
400,2021-03-12,783617,1109,655164,842,128453,267,755549,6200512,6956061,13676,16,11631,-30,5826,1123,766160,34,26124,12139,24
401,2021-03-11,782508,1359,654322,923,128186,436,754561,6187824,6942385,19466,17,11615,161,5856,1181,765037,42,26090,12115,14
402,2021-03-10,781149,1597,653399,1135,127750,462,753519,6169400,6922919,23672,18,11598,294,5695,1285,763856,62,26048,12101,28
403,2021-03-09,779552,1345,652264,804,127288,541,752241,6147006,6899247,17077,32,11580,-43,5401,1356,762571,48,25986,12073,23
404,2021-03-08,778207,1083,651460,680,126747,403,751311,6130859,6882170,7437,9,11548,-567,5444,1641,761215,27,25938,12050,29
405,2021-03-07,777124,752,650780,475,126344,277,750560,6124173,6874733,7156,4,11539,-200,6011,948,759574,16,25911,12021,24
406,2021-03-06,776372,1236,650305,846,126067,390,750008,6117569,6867577,18288,9,11535,165,6211,1062,758626,37,25895,11997,22
407,2021-03-05,775136,1225,649459,782,125677,443,749004,6100285,6849289,14123,33,11526,-76,6046,1268,757564,34,25858,11975,21
408,2021-03-04,773911,1599,648677,1063,125234,536,748104,6087062,6835166,25013,42,11493,557,6122,1000,756296,49,25824,11954,18
409,2021-03-03,772312,1299,647614,882,124698,417,746870,6063283,6810153,18270,23,11451,7,5565,1269,755296,39,25775,11936,23
410,2021-03-02,771013,1544,646732,987,124281,557,745818,6046065,6791883,16044,15,11428,516,5558,1013,754027,49,25736,11913,23
411,2021-03-01,769469,566,645745,363,123724,203,744651,6031188,6775839,3756,10,11413,-436,5042,992,753014,26,25687,11890,23
412,2021-02-28,768903,837,645382,581,123521,256,744253,6027830,6772083,10303,18,11403,-74,5478,893,752022,21,25661,11867,21
413,2021-02-27,768066,1442,644801,859,123265,583,743562,6018218,6761780,17905,16,11385,387,5552,1039,751129,32,25640,11846,21
414,2021-02-26,766624,1124,643942,787,122682,337,742563,6001312,6743875,12036,56,11369,-563,5165,1631,750090,27,25608,11825,18
415,2021-02-25,765500,1678,643155,1176,122345,502,741637,5990202,6731839,22345,55,11313,-92,5728,1715,748459,60,25581,11807,27
416,2021-02-24,763822,1912,641979,1473,121843,439,740301,5969193,6709494,24492,68,11258,-51,5820,1895,746744,68,25521,11780,22
417,2021-02-23,761910,1843,640506,1136,121404,707,738616,5946386,6685002,17034,45,11190,-365,5871,2163,744849,67,25453,11758,24
418,2021-02-22,760067,1056,639370,608,120697,448,737351,5930617,6667968,6100,20,11145,-1284,6236,2320,742686,61,25386,11734,33
419,2021-02-21,759011,871,638762,583,120249,288,736662,5925206,6661868,6613,18,11125,-276,7520,1129,740366,33,25325,11701,33
420,2021-02-20,758140,1366,638179,840,119961,526,735986,5919269,6655255,12772,51,11107,-45,7796,1360,739237,53,25292,11668,25
421,2021-02-19,756774,994,637339,642,119435,352,735026,5907457,6642483,6593,7,11056,-930,7841,1917,737877,46,25239,11643,36
422,2021-02-18,755780,1480,636697,950,119083,530,734286,5901604,6635890,12969,72,11049,-659,8771,2067,735960,54,25193,11607,36
423,2021-02-17,754300,929,635747,597,118553,332,733213,5889708,6622921,6495,31,10977,-1308,9430,2206,733893,21,25139,11571,44
424,2021-02-16,753371,1224,635150,788,118221,436,732541,5883885,6616426,10030,17,10946,-1259,10738,2466,731687,45,25118,11527,34
425,2021-02-15,752147,778,634362,456,117785,322,731653,5874743,6606396,6251,4,10929,-2023,11997,2797,729221,22,25073,11493,32
426,2021-02-14,751369,1253,633906,899,117463,354,731120,5869025,6600145,12891,31,10925,-368,14020,1590,726424,34,25051,11461,35
427,2021-02-13,750116,1671,633007,1116,117109,555,730111,5857143,6587254,19310,9,10894,-8,14388,1670,724834,52,25017,11426,38
428,2021-02-12,748445,1923,631891,1382,116554,541,728758,5839186,6567944,22220,81,10885,-406,14396,2248,723164,37,24965,11388,28
429,2021-02-11,746522,2416,630509,1743,116013,673,727160,5818564,6545724,25305,81,10804,-288,14802,2623,720916,65,24928,11360,37
430,2021-02-10,744106,2137,628766,1520,115340,617,725161,5795258,6520419,24639,100,10723,-579,15090,2616,718293,60,24863,11323,39
431,2021-02-09,741969,2687,627246,1776,114723,911,723394,5772386,6495780,21202,65,10623,-602,15669,3224,715677,81,24803,11284,40
432,2021-02-08,739282,1238,625470,780,113812,458,721357,5753221,6474578,6687,97,10558,-2342,16271,3483,712453,39,24722,11244,38
433,2021-02-07,738044,1350,624690,939,113354,411,720442,5747449,6467891,12998,6,10461,-458,18613,1802,708970,41,24683,11206,31
434,2021-02-06,736694,3657,623751,2594,112943,1063,719347,5735546,6454893,39223,58,10455,1581,19071,2018,707168,64,24642,11175,62
435,2021-02-05,733037,2192,621157,1584,111880,608,716255,5699415,6415670,21867,203,10397,-759,17490,2748,705150,63,24578,11113,54
436,2021-02-04,730845,2895,619573,2090,111272,805,714445,5679358,6393803,33092,169,10194,-538,18249,3264,702402,85,24515,11059,51
437,2021-02-03,727950,3343,617483,2264,110467,1079,712009,5648702,6360711,27625,133,10025,23,18787,3187,699138,96,24430,11008,42
438,2021-02-02,724607,1313,615219,845,109388,468,709448,5623638,6333086,6600,147,9892,-2907,18764,4073,695951,34,24334,10966,46
439,2021-02-01,723294,1688,614374,1064,108920,624,708533,5617953,6326486,8122,103,9745,-1896,21671,3481,691878,52,24300,10920,55
440,2021-01-31,721606,2169,613310,1383,108296,786,707383,5610981,6318364,16993,76,9642,-44,23567,2137,688397,55,24248,10865,52
441,2021-01-30,719437,3514,611927,2941,107510,573,705790,5595581,6301371,38392,113,9566,785,23611,2616,686260,57,24193,10813,54
442,2021-01-29,715923,1761,608986,1242,106937,519,702260,5560719,6262979,13768,44,9453,-1918,22826,3635,683644,40,24136,10759,58
443,2021-01-28,714162,3951,607744,2032,106418,1919,700786,5548425,6249211,20263,101,9409,-365,24744,4215,680009,85,24096,10701,75
444,2021-01-27,710211,2720,605712,2066,104499,654,698600,5530348,6228948,20594,154,9308,-1281,25109,3847,675794,66,24011,10626,63
445,2021-01-26,707491,3132,603646,2325,103845,807,696261,5512093,6208354,22516,192,9154,-1953,26390,4893,671947,80,23945,10563,82
446,2021-01-25,704359,1814,601321,1219,103038,595,693667,5492171,6185838,11551,111,8962,-3531,28343,5234,667054,58,23865,10481,78
447,2021-01-24,702545,1595,600102,1306,102443,289,692307,5481980,6174287,13146,40,8851,-1696,31874,3251,661820,43,23807,10403,85
448,2021-01-23,700950,4471,598796,3165,102154,1306,690791,5470350,6161141,37264,42,8811,1069,33570,3360,658569,94,23764,10318,78
449,2021-01-22,696479,2632,595631,1965,100848,667,686969,5436908,6123877,21103,93,8769,-2526,32501,5065,655209,56,23670,10240,79
450,2021-01-21,693847,4687,593666,3496,100181,1191,684712,5418062,6102774,32231,128,8676,-1983,35027,6542,650144,94,23614,10161,116
451,2021-01-20,689160,3098,590170,2091,98990,1007,680725,5389818,6070543,19971,86,8548,-2806,37010,5818,643602,65,23520,10045,90
452,2021-01-19,686062,4784,588079,2808,97983,1976,678298,5372274,6050572,21943,40,8462,-3179,39816,7923,637784,119,23455,9955,104
453,2021-01-18,681278,1616,585271,1069,96007,547,675159,5353470,6028629,8271,39,8422,-7277,42995,8854,629861,44,23336,9851,84
454,2021-01-17,679662,2575,584202,1887,95460,688,673999,5346359,6020358,15901,36,8383,-1935,50272,4474,621007,55,23292,9767,95
455,2021-01-16,677087,6910,582315,5337,94772,1573,671806,5332651,6004457,45637,44,8347,1251,52207,5615,616533,134,23237,9672,95
456,2021-01-15,670177,2754,576978,1817,93199,937,665486,5293334,5958820,14692,79,8303,-714,50956,3389,610918,68,23103,9577,94
457,2021-01-14,667423,6155,575161,4813,92262,1342,663514,5280614,5944128,36398,84,8224,-288,51670,6359,607529,107,23035,9483,113
458,2021-01-13,661268,4110,570348,2875,90920,1235,658101,5249629,5907730,21471,137,8140,-4050,51958,8023,601170,72,22928,9370,83
459,2021-01-12,657158,4736,567473,3015,89685,1721,654993,5231266,5886259,20965,146,8003,-5989,56008,10579,593147,82,22856,9287,105
460,2021-01-11,652422,3774,564458,2676,87964,1098,651702,5213592,5865294,14819,80,7857,-6334,61997,10028,582568,78,22774,9182,108
461,2021-01-10,648648,5369,561782,3693,86866,1676,648759,5201716,5850475,29756,81,7777,1015,68331,4273,572540,92,22696,9074,109
462,2021-01-09,643279,7205,558089,5744,85190,1461,644274,5176445,5820719,38822,86,7696,1993,67316,5126,568267,103,22604,8965,93
463,2021-01-08,636074,6054,552345,4580,83729,1474,637770,5144127,5781897,33501,126,7610,4239,65323,1689,563141,104,22501,8872,123
464,2021-01-07,630020,7330,547765,6300,82255,1030,631858,5116538,5748396,34165,111,7484,3138,61084,4081,561452,113,22397,8749,95
465,2021-01-06,622690,7352,541465,5170,81225,2182,625363,5088868,5714231,29291,114,7373,442,57946,6796,557371,140,22284,8654,116
466,2021-01-05,615338,8399,536295,5158,79043,3241,619704,5065236,5684940,25767,99,7259,-757,57504,9057,550575,145,22144,8538,119
467,2021-01-04,606939,4043,531137,3002,75802,1041,614368,5044805,5659173,10784,143,7160,-4602,58261,8502,541518,71,21999,8419,111
468,2021-01-03,602896,3505,528135,2368,74761,1137,611432,5036957,5648389,12686,55,7017,-268,62863,3718,533016,64,21928,8308,105
469,2021-01-02,599391,7193,525767,5733,73624,1460,608923,5026780,5635703,29334,15,6962,3106,63131,4072,529298,110,21864,8203,92
470,2021-01-01,592198,6672,520034,5224,72164,1448,602637,5003732,5606369,28499,48,6947,-405,60025,7029,525226,93,21754,8111,104
471,2020-12-31,585526,9170,514810,7248,70716,1922,596856,4981014,5577870,35342,97,6899,1922,60430,7151,518197,96,21661,8007,102
472,2020-12-30,576356,6690,507562,4535,68794,2155,588822,4953706,5542528,22078,100,6802,-704,58508,7294,511046,97,21565,7905,99
473,2020-12-29,569666,8068,503027,4958,66639,3110,583895,4936555,5520450,23776,122,6702,63,59212,7883,503752,142,21468,7806,98
474,2020-12-28,561598,3540,498069,2632,63529,908,578440,4918234,5496674,10043,76,6580,-6576,59149,10040,495869,102,21326,7708,93
475,2020-12-27,558058,3376,495437,2298,62621,1078,575630,4911001,5486631,12296,69,6504,-448,65725,3755,485829,87,21224,7615,90
476,2020-12-26,554682,4883,493139,3549,61543,1334,573032,4901303,5474335,22325,7,6435,825,66173,4051,482074,113,21137,7525,94
477,2020-12-25,549799,6617,489590,5433,60209,1184,569032,4882978,5452010,33667,5,6428,-554,65348,7166,478023,83,21024,7431,83
478,2020-12-24,543182,6638,484157,5033,59025,1605,562923,4855420,5418343,32541,51,6423,-515,65902,7102,470857,68,20941,7348,106
479,2020-12-23,536544,6080,479124,3980,57420,2100,557187,4828615,5385802,25872,111,6372,-1331,66417,7300,463755,102,20873,7242,97
480,2020-12-22,530464,6898,475144,4710,55320,2188,552773,4807157,5359930,28840,133,6261,-804,67748,7569,456455,155,20771,7145,112
481,2020-12-21,523566,5813,470434,4377,53132,1436,547526,4783564,5331090,26501,65,6128,-3904,68552,9652,448886,103,20616,7033,107
482,2020-12-20,517753,9970,466057,8328,51696,1642,542618,4761971,5304589,60906,54,6063,6388,72456,3528,439234,137,20513,6926,102
483,2020-12-19,507783,7061,457729,6029,50054,1032,533078,4710605,5243683,40082,57,6009,3170,66068,3834,435706,97,20376,6824,95
484,2020-12-18,500722,8255,451700,6992,49022,1263,526174,4677427,5203601,41246,115,5952,1883,62898,6257,431872,155,20279,6729,98
485,2020-12-17,492467,10138,444708,8066,47759,2072,518497,4643858,5162355,45088,177,5837,3144,61015,6817,425615,185,20124,6631,93
486,2020-12-16,482329,9295,436642,6484,45687,2811,509566,4607701,5117267,36029,53,5660,2251,57871,6991,418798,222,19939,6538,87
487,2020-12-15,473034,11787,430158,10301,42876,1486,502412,4578826,5081238,65199,74,5607,4591,55620,7122,411807,248,19717,6451,68
488,2020-12-14,461247,7903,419857,6852,41390,1051,490727,4525312,5016039,41727,79,5533,-2507,51029,10331,404685,172,19469,6383,78
489,2020-12-13,453344,11186,413005,9828,40339,1358,483127,4491185,4974312,69069,62,5454,7699,53536,3425,394354,181,19297,6305,86
490,2020-12-12,442158,8885,403177,7281,38981,1604,471989,4433254,4905243,47545,73,5392,4973,45837,3839,390929,183,19116,6219,83
491,2020-12-11,433273,6024,395896,5100,37377,924,463712,4393986,4857698,31990,87,5319,1708,40864,4229,387090,161,18933,6136,70
492,2020-12-10,427249,8853,390796,7748,36453,1105,458155,4367553,4825708,52201,69,5232,7510,39156,1274,382861,178,18772,6066,77
493,2020-12-09,418396,5778,383048,5126,35348,652,449448,4324059,4773507,27049,62,5163,141,31646,5575,381587,139,18594,5989,64
494,2020-12-08,412618,8062,377922,7006,34696,1056,443876,4302582,4746458,45340,100,5101,2337,31505,5625,376012,164,18455,5925,80
495,2020-12-07,404556,7110,370916,6127,33640,983,436124,4264994,4701118,35833,66,5001,-709,29168,7753,370387,136,18291,5845,74
496,2020-12-06,397446,4027,364789,3400,32657,627,429403,4235882,4665285,19682,38,4935,1144,29877,2845,362634,66,18155,5771,86
497,2020-12-05,393419,3061,361389,2510,32030,551,425699,4219904,4645603,15755,29,4897,27,28733,3005,359789,69,18089,5685,80
498,2020-12-04,390358,5358,358879,4297,31479,1061,423008,4206840,4629848,26782,95,4868,-299,28706,5562,356784,132,18020,5605,85
499,2020-12-03,385000,4789,354582,3992,30418,797,418192,4184874,4603066,25413,93,4773,580,29005,4116,351222,101,17888,5520,74
500,2020-12-02,380211,2493,350590,2105,29621,388,413823,4163830,4577653,11732,50,4680,-2537,28425,4980,347106,76,17787,5446,68
501,2020-12-01,377718,6634,348485,5659,29233,975,411660,4154261,4565921,36377,36,4630,1027,30962,5571,342126,145,17711,5378,70
502,2020-11-30,371084,5938,342826,5380,28258,558,405441,4124103,4529544,40826,48,4594,-1177,29935,7067,336555,106,17566,5308,82
503,2020-11-29,365146,5466,337446,5048,27700,418,399442,4089276,4488718,37781,13,4546,2454,31112,2999,329488,92,17460,5226,59
504,2020-11-28,359680,4637,332398,4046,27282,591,393733,4057204,4450937,32008,15,4533,1554,28658,3068,326489,98,17368,5167,65
505,2020-11-27,355043,5383,328352,4789,26691,594,389179,4029750,4418929,32532,7,4518,388,27104,4988,323421,93,17270,5102,82
506,2020-11-26,349660,5237,323563,4889,26097,348,383670,4002727,4386397,52138,53,4511,-460,26716,5644,318433,84,17177,5020,47
507,2020-11-25,344423,2198,318674,1596,25749,602,377798,3956461,4334259,11966,92,4458,-2353,27176,4459,312789,102,17093,4973,65
508,2020-11-24,342225,2049,317078,1529,25147,520,376343,3945950,4322293,10728,73,4366,-3410,29529,5386,308330,105,16991,4908,66
509,2020-11-23,340176,2207,315549,1853,24627,354,374834,3936731,4311565,11342,35,4293,-4637,32939,6809,302944,80,16886,4842,70
510,2020-11-22,337969,5508,313696,5016,24273,492,372956,3927267,4300223,43957,55,4258,2867,37576,2586,296135,135,16806,4772,59
511,2020-11-21,332461,3412,308680,2908,23781,504,367297,3888969,4256266,25737,9,4203,802,34709,2601,293549,110,16671,4713,76
512,2020-11-20,329049,4014,305772,3513,23277,501,364157,3866372,4230529,24631,74,4194,-43,33907,3983,290948,121,16561,4637,69
513,2020-11-19,325035,2985,302259,2290,22776,695,360297,3845601,4205898,16543,80,4120,-1338,33950,4243,286965,125,16440,4568,60
514,2020-11-18,322050,4014,299969,3054,22081,960,357883,3831472,4189355,23882,53,4040,-91,35288,4052,282722,155,16315,4508,46
515,2020-11-17,318036,3502,296915,3184,21121,318,354465,3811008,4165473,21283,72,3987,-101,35379,3531,278670,103,16160,4462,68
516,2020-11-16,314534,4631,293731,4227,20803,404,350914,3793276,4144190,35556,30,3915,-46,35480,4647,275139,151,16057,4394,54
517,2020-11-15,309903,6423,289504,5818,20399,605,346193,3762441,4108634,55153,16,3885,4491,35526,1916,270492,184,15906,4340,48
518,2020-11-14,303480,4851,283686,4429,19794,422,339608,3713873,4053481,38307,25,3869,3026,31035,1800,268576,146,15722,4292,61
519,2020-11-13,298629,4336,279257,3733,19372,603,334586,3680588,4015174,27460,64,3844,1519,28009,2753,266776,122,15576,4231,43
520,2020-11-12,294293,3139,275524,2582,18769,557,330569,3657145,3987714,19160,27,3780,409,26490,2703,264023,110,15454,4188,38
521,2020-11-11,291154,3906,272942,3292,18212,614,327838,3640716,3968554,28258,89,3753,995,26081,2822,261320,132,15344,4150,50
522,2020-11-10,287248,3005,269650,2481,17598,524,324023,3616273,3940296,25238,62,3664,94,25086,2849,258498,121,15212,4100,51
523,2020-11-09,284243,2373,267169,2054,17074,319,321294,3593764,3915058,19658,15,3602,-880,24992,3238,255649,85,15091,4049,44
524,2020-11-08,281870,5349,265115,4820,16755,529,318977,3576423,3895400,55324,5,3587,3537,25872,1807,252411,179,15006,4005,40
525,2020-11-07,276521,4156,260295,3833,16226,323,313434,3526642,3840076,43170,49,3582,2241,22335,1866,250604,144,14827,3965,33
526,2020-11-06,272365,3571,256462,3015,15903,556,308946,3487960,3796906,28745,32,3533,937,20094,2602,248738,105,14683,3932,47
527,2020-11-05,268794,1402,253447,1112,15347,290,305581,3462580,3768161,10722,31,3501,-1310,19157,2681,246136,80,14578,3885,40
528,2020-11-04,267392,2631,252335,2338,15057,293,304346,3453093,3757439,23429,24,3470,-161,20467,2768,243455,107,14498,3845,50
529,2020-11-03,264761,2999,249997,2695,14764,304,301732,3432278,3734010,24849,75,3446,232,20628,2692,240687,82,14391,3795,46
530,2020-11-02,261762,1885,247302,1761,14460,124,298702,3410459,3709161,16833,26,3371,-1356,20396,3215,237995,78,14309,3749,38
531,2020-11-01,259877,2470,245541,2107,14336,363,296742,3395586,3692328,33694,0,3345,769,21752,1701,234780,109,14231,3711,32
532,2020-10-31,257407,148,243434,136,13973,12,294292,3364342,3658634,811,12,3345,-1534,20983,1670,233079,3,14122,3679,31
533,2020-10-30,257259,2383,243298,2169,13961,214,294151,3363672,3657823,22519,78,3333,86,22517,2219,231409,83,14119,3648,40
534,2020-10-29,254876,2358,241129,2033,13747,325,291773,3343531,3635304,25221,22,3255,28,22431,2308,229190,98,14036,3608,40
535,2020-10-28,252518,2662,239096,2381,13422,281,289511,3320572,3610083,23465,34,3233,138,22403,2490,226882,105,13938,3568,38
536,2020-10-27,249856,2435,236715,2033,13141,402,286871,3299747,3586618,22624,44,3199,-10,22265,2401,224392,139,13833,3530,46
537,2020-10-26,247421,1490,234682,1305,12739,185,284565,3279429,3563994,11304,32,3155,-1377,22275,2835,221991,64,13694,3484,30
538,2020-10-25,245931,3072,233377,2884,12554,188,283118,3269572,3552690,35766,31,3123,1575,23652,1466,219156,137,13630,3454,42
539,2020-10-24,242859,3577,230493,3287,12366,290,279644,3237280,3516924,40053,24,3092,1894,22077,1659,217690,141,13493,3412,45
540,2020-10-23,239282,2639,227206,2393,12076,246,275840,3201031,3476871,29752,65,3068,501,20183,2073,216031,128,13352,3367,34
541,2020-10-22,236643,3166,224813,2819,11830,347,273182,3173937,3447119,35915,41,3003,1122,19682,2003,213958,133,13224,3333,28
542,2020-10-21,233477,1723,221994,1478,11483,245,269990,3141214,3411204,15150,18,2962,-528,18560,2233,211955,77,13091,3305,38
543,2020-10-20,231754,1943,220516,1662,11238,281,268301,3127753,3396054,17080,30,2944,-94,19088,2007,209722,96,13014,3267,37
544,2020-10-19,229811,2173,218854,1979,10957,194,266444,3112530,3378974,21960,13,2914,-189,19182,2349,207715,128,12918,3230,33
545,2020-10-18,227638,2619,216875,2449,10763,170,264213,3092801,3357014,39537,6,2901,1303,19371,1310,205366,124,12790,3197,21
546,2020-10-17,225019,2661,214426,2460,10593,201,261309,3056168,3317477,36709,32,2895,1282,18068,1347,204056,104,12666,3176,29
547,2020-10-16,222358,1706,211966,1517,10392,189,258368,3022400,3280768,16313,7,2863,-137,16786,1836,202709,67,12562,3147,29
548,2020-10-15,220652,1412,210449,1214,10203,198,256790,3007665,3264455,16187,36,2856,-321,16923,1697,200873,77,12495,3118,41
549,2020-10-14,219240,2297,209235,2098,10005,199,255437,2992831,3248268,22257,31,2820,557,17244,1709,199176,99,12418,3077,37
550,2020-10-13,216943,1535,207137,1266,9806,269,253217,2972794,3226011,16043,23,2789,-16,16687,1528,197467,89,12319,3040,36
551,2020-10-12,215408,1223,205871,1045,9537,178,251793,2958175,3209968,15532,7,2766,-827,16703,2043,195939,64,12230,3004,36
552,2020-10-11,214185,2930,204826,2736,9359,194,250588,2943848,3194436,42640,9,2759,1839,17530,1082,193896,153,12166,2968,28
553,2020-10-10,211255,1871,202090,1766,9165,105,247437,2904359,3151796,29600,26,2750,826,15691,1019,192814,79,12013,2940,30
554,2020-10-09,209384,1406,200324,1237,9060,169,245423,2876773,3122196,25934,27,2724,49,14865,1330,191795,62,11934,2910,26
555,2020-10-08,207978,1991,199087,1803,8891,188,244037,2852225,3096262,25694,63,2697,531,14816,1397,190465,88,11872,2884,28
556,2020-10-07,205987,1833,197284,1569,8703,264,242107,2828461,3070568,23358,21,2634,353,14285,1459,189068,109,11784,2856,28
557,2020-10-06,204154,1993,195715,1700,8439,293,240366,2806844,3047210,25168,24,2613,447,13932,1522,187609,132,11675,2828,27
558,2020-10-05,202161,2201,194015,1991,8146,210,238403,2783639,3022042,35588,20,2589,362,13485,1819,186087,130,11543,2801,25
559,2020-10-04,199960,1802,192024,1654,7936,148,235921,2750533,2986454,38287,17,2569,867,13123,918,184268,100,11413,2776,30
560,2020-10-03,198158,1348,190370,1237,7788,111,233786,2714381,2948167,29086,45,2552,336,12256,967,183350,63,11313,2746,18
561,2020-10-02,196810,1196,189133,1060,7677,136,232167,2686914,2919081,15594,14,2507,-293,11920,1475,182383,69,11250,2728,22
562,2020-10-01,195614,1142,188073,1001,7541,141,230869,2672618,2903487,18440,47,2493,-308,12213,1403,180908,77,11181,2706,21
563,2020-09-30,194472,1425,187072,1253,7400,172,229671,2655376,2885047,13668,34,2446,-78,12521,1469,179505,51,11104,2685,27
564,2020-09-29,193047,1186,185819,972,7228,214,228193,2643186,2871379,20804,31,2412,-291,12599,1446,178036,86,11053,2658,14
565,2020-09-28,191861,670,184847,544,7014,126,226888,2623687,2850575,8494,12,2381,-1230,12890,1888,176590,41,10967,2644,26
566,2020-09-27,191191,1356,184303,1270,6888,86,226182,2615899,2842081,29425,3,2369,428,14120,925,174702,66,10926,2618,26
567,2020-09-26,189835,2114,183033,1973,6802,141,224645,2588011,2812656,44144,22,2366,1028,13692,1064,173777,81,10860,2592,23
568,2020-09-25,187721,1337,181060,1237,6661,100,222192,2546320,2768512,26054,42,2344,-111,12664,1406,172713,65,10779,2569,24
569,2020-09-24,186384,1394,179823,1227,6561,167,220673,2521785,2742458,26990,35,2302,-99,12775,1458,171307,69,10714,2545,20
570,2020-09-23,184990,914,178596,798,6394,116,219169,2496299,2715468,9555,14,2267,-617,12874,1517,169849,36,10645,2525,29
571,2020-09-22,184076,1635,177798,1418,6278,217,218217,2487696,2705913,25553,28,2253,-184,13491,1791,168332,76,10609,2496,20
572,2020-09-21,182441,664,176380,519,6061,145,216330,2464030,2680360,7053,15,2225,-392,13675,1041,166541,49,10533,2476,20
573,2020-09-20,181777,1022,175861,909,5916,113,215621,2457686,2673307,20388,2,2210,139,14067,881,165500,50,10484,2456,26
574,2020-09-19,180755,2124,174952,2024,5803,100,214415,2438504,2652919,48381,20,2208,1202,13928,902,164619,118,10434,2430,18
575,2020-09-18,178631,1501,172928,1328,5703,173,211930,2392608,2604538,30006,32,2188,-304,12726,1773,163717,68,10316,2412,28
576,2020-09-17,177130,1815,171600,1677,5530,138,210259,2364273,2574532,27713,13,2156,422,13030,1380,161944,68,10248,2384,26
577,2020-09-16,175315,1054,169923,924,5392,130,208222,2338597,2546819,16886,24,2143,-375,12608,1405,160564,59,10180,2358,22
578,2020-09-15,174261,1890,168999,1670,5262,220,207018,2322915,2529933,34232,30,2119,297,12983,1563,159159,97,10121,2336,17
579,2020-09-14,172371,1596,167329,1433,5042,163,204736,2290965,2495701,22927,19,2089,-67,12686,1644,157596,102,10024,2319,27
580,2020-09-13,170775,1390,165896,1306,4879,84,202951,2269823,2472774,22624,14,2070,381,12753,995,155952,55,9922,2292,14
581,2020-09-12,169385,1321,164590,1244,4795,77,201284,2248866,2450150,26752,39,2056,458,12372,824,154957,51,9867,2278,35
582,2020-09-11,168064,1001,163346,891,4718,110,199626,2223772,2423398,15173,37,2017,-1365,11914,2329,154133,54,9816,2243,28
583,2020-09-10,167063,1994,162455,1817,4608,177,198513,2209712,2408225,31347,57,1980,513,13279,1424,151804,87,9762,2215,23
584,2020-09-09,165069,1135,160638,1030,4431,105,196281,2180597,2376878,17900,35,1923,-354,12766,1454,150380,67,9675,2192,23
585,2020-09-08,163934,815,159608,707,4326,108,194951,2164027,2358978,13214,27,1888,-742,13120,1530,148926,51,9608,2169,25
586,2020-09-07,163119,779,158901,732,4218,47,194091,2151673,2345764,7879,4,1861,-953,13862,1728,147396,40,9557,2144,17
587,2020-09-06,162340,822,158169,771,4171,51,192964,2144921,2337885,12140,3,1857,-67,14815,886,145668,41,9517,2127,35
588,2020-09-05,161518,2550,157398,2481,4120,69,192053,2133692,2325745,35184,25,1854,1524,14882,1001,144782,59,9476,2092,22
589,2020-09-04,158968,1110,154917,1031,4051,79,189134,2101427,2290561,13308,22,1829,-159,13358,1247,143781,51,9417,2070,21
590,2020-09-03,157858,1651,153886,1510,3972,141,187946,2089307,2277253,28564,18,1807,24,13517,1609,142534,62,9366,2049,22
591,2020-09-02,156207,1181,152376,1075,3831,106,186052,2062637,2248689,16328,16,1789,-315,13493,1480,140925,58,9304,2027,23
592,2020-09-01,155026,1683,151301,1520,3725,163,184806,2047555,2232361,23060,27,1773,122,13808,1534,139445,74,9246,2004,22
593,2020-08-31,153343,1237,149781,1168,3562,69,182827,2026474,2209301,12818,7,1746,-349,13686,1579,137911,43,9172,1982,25
594,2020-08-30,152106,1460,148613,1427,3493,33,181427,2015056,2196483,8544,22,1739,524,14035,914,136332,40,9129,1957,16
595,2020-08-29,150646,1525,147186,1418,3460,107,179822,2008117,2187939,25423,24,1717,362,13511,1139,135418,56,9089,1941,25
596,2020-08-28,149121,1123,145768,1069,3353,54,178043,1984473,2162516,12751,28,1693,-467,13149,1562,134279,52,9033,1916,25
597,2020-08-27,147998,2325,144699,2201,3299,124,176757,1973008,2149765,37060,25,1665,907,13616,1393,132717,73,8981,1891,26
598,2020-08-26,145673,1309,142498,1194,3175,115,174037,1938668,2112705,18047,20,1640,-393,12709,1682,131324,58,8908,1865,30
599,2020-08-25,144364,1697,141304,1580,3060,117,172511,1922147,2094658,30514,40,1620,119,13102,1538,129642,71,8850,1835,25
600,2020-08-24,142667,644,139724,531,2943,113,170512,1893632,2064144,7024,21,1580,-1387,12983,2010,128104,42,8779,1810,35
601,2020-08-23,142023,810,139193,749,2830,61,169815,1887305,2057120,14498,4,1559,-206,14370,1012,126094,42,8737,1775,24
602,2020-08-22,141213,2423,138444,2360,2769,63,168894,1873728,2042622,52095,14,1555,1229,14576,1180,125082,77,8695,1751,17
603,2020-08-21,138790,525,136084,482,2706,43,165960,1824567,1990527,10359,61,1541,-1216,13347,1680,123902,32,8618,1734,21
604,2020-08-20,138265,2426,135602,2253,2663,173,165397,1814771,1980168,42752,36,1480,754,14563,1636,122222,89,8586,1713,20
605,2020-08-19,135839,1334,133349,1268,2490,66,162617,1774799,1937416,20256,26,1444,-535,13809,1843,120586,57,8497,1693,22
606,2020-08-18,134505,1755,132081,1641,2424,114,161048,1756112,1917160,37943,39,1418,-213,14344,1929,118743,68,8440,1671,17
607,2020-08-17,132750,839,130440,706,2310,133,158596,1720621,1879217,9074,21,1379,-1292,14557,2110,116814,61,8372,1654,20
608,2020-08-16,131911,1397,129734,1371,2177,26,157721,1712422,1870143,20070,21,1358,296,15849,1080,114704,46,8311,1634,30
609,2020-08-15,130514,1920,128363,1835,2151,85,155916,1694157,1850073,27261,19,1337,575,15553,1326,113624,67,8265,1604,30
610,2020-08-14,128594,1369,126528,1288,2066,81,153403,1669409,1822812,15123,13,1318,-354,14978,1710,112298,50,8198,1574,22
611,2020-08-13,127225,2501,125240,2403,1985,98,151776,1655913,1807689,36480,24,1305,574,15332,1903,110588,126,8148,1552,24
612,2020-08-12,124724,1242,122837,1203,1887,39,148475,1622734,1771209,13803,18,1281,-765,14758,1989,108685,61,8022,1528,25
613,2020-08-11,123482,1797,121634,1683,1848,114,147068,1610338,1757406,24156,38,1263,-166,15523,1925,106696,85,7961,1503,26
614,2020-08-10,121685,894,119951,842,1734,52,144920,1588330,1733250,8438,10,1225,-1466,15689,2350,104771,82,7876,1477,30
615,2020-08-09,120791,1567,119109,1540,1682,27,143938,1580874,1724812,17473,8,1215,449,17155,1110,102421,62,7794,1447,15
616,2020-08-08,119224,2096,117569,2034,1655,62,142036,1565303,1707339,33952,9,1207,934,16706,1153,101311,92,7732,1432,22
617,2020-08-07,117128,1775,115535,1724,1593,51,139413,1533974,1673387,18426,20,1198,118,15772,1637,100158,129,7640,1410,25
618,2020-08-06,115353,2724,113811,2613,1542,111,137276,1517685,1654961,32188,42,1178,1006,15654,1676,98521,140,7511,1385,25
619,2020-08-05,112629,1339,111198,1272,1431,67,133971,1488802,1622773,14096,27,1136,-640,14648,1952,96845,70,7371,1360,18
620,2020-08-04,111290,1734,109926,1651,1364,83,132441,1476236,1608677,21049,25,1109,-360,15288,2069,94893,122,7301,1342,20
621,2020-08-03,109556,1788,108275,1755,1281,33,130361,1457267,1587628,16814,19,1084,-689,15648,2458,92824,84,7179,1322,25
622,2020-08-02,107768,1071,106520,1048,1248,23,128275,1442539,1570814,13183,6,1065,-83,16337,1148,90366,67,7095,1297,37
623,2020-08-01,106697,2151,105472,2122,1225,29,126989,1430642,1557631,31920,7,1059,806,16420,1338,89218,97,7028,1260,23
624,2020-07-31,104546,1743,103350,1695,1196,48,124217,1401494,1525711,18454,27,1052,-104,15614,1820,87880,97,6931,1237,29
625,2020-07-30,102803,3552,101655,3509,1148,43,122254,1385003,1507257,42885,13,1025,1635,15718,1904,86060,174,6834,1208,29
626,2020-07-29,99251,1173,98146,1146,1105,27,117923,1346449,1464372,9569,21,1012,-1231,14083,2383,84156,88,6660,1179,33
627,2020-07-28,98078,2487,97000,2443,1078,44,116624,1338179,1454803,28668,21,991,129,15314,2337,81773,169,6572,1146,21
628,2020-07-27,95591,1896,94557,1857,1034,39,113539,1312596,1426135,17974,11,970,-808,15185,2693,79436,126,6403,1125,17
629,2020-07-26,93695,2301,92700,2249,995,52,111279,1296882,1408161,26771,3,959,965,15993,1333,76743,106,6277,1108,21
630,2020-07-25,91394,3073,90451,3034,943,39,108448,1272942,1381390,38564,26,956,1581,15028,1466,75410,162,6171,1087,20
631,2020-07-24,88321,1840,87417,1796,904,44,104643,1238183,1342826,22638,13,930,-356,13447,2183,73944,124,6009,1067,29
632,2020-07-23,86481,2512,85621,2464,860,48,102280,1217908,1320188,37790,37,917,396,13803,2079,71761,149,5885,1038,28
633,2020-07-22,83969,1979,83157,1951,812,28,99097,1183301,1282398,17278,17,880,-459,13407,2421,69682,122,5736,1010,29
634,2020-07-21,81990,3137,81206,3110,784,27,96763,1168357,1265120,39697,24,863,591,13866,2522,67261,188,5614,981,17
635,2020-07-20,78853,1192,78096,1155,757,37,92866,1132557,1225423,9762,4,839,-1594,13275,2782,64739,62,5426,964,20
636,2020-07-19,77661,1569,76941,1546,720,23,91533,1124128,1215661,18801,5,835,-29,14869,1593,61957,74,5364,944,17
637,2020-07-18,76092,2110,75395,2090,697,20,89581,1107279,1196860,26370,23,830,807,14898,1280,60364,104,5290,927,17
638,2020-07-17,73982,2120,73305,2076,677,44,86898,1083592,1170490,22185,19,807,523,14091,1578,59084,113,5186,910,16
639,2020-07-16,71862,2947,71229,2905,633,42,84339,1063966,1148305,39510,13,788,1100,13568,1834,57506,142,5073,894,17
640,2020-07-15,68915,1921,68324,1884,591,37,80529,1028266,1108795,19716,16,775,-114,12468,2019,55672,121,4931,877,17
641,2020-07-14,66994,2103,66440,2064,554,39,78337,1010742,1089079,23644,18,759,210,12582,1875,53653,127,4810,860,12
642,2020-07-13,64891,1816,64376,1786,515,30,75829,989606,1065435,17508,8,741,-87,12372,1895,51778,89,4683,848,18
643,2020-07-12,63075,2315,62590,2289,485,26,73810,974117,1047927,28202,3,733,1210,12459,1102,49883,126,4594,830,17
644,2020-07-11,60760,1174,60301,1160,459,14,70923,948802,1019725,15261,15,730,21,11249,1138,48781,58,4468,813,14
645,2020-07-10,59586,1964,59141,1936,445,28,69422,935042,1004464,18446,13,715,566,11228,1385,47643,104,4410,799,17
646,2020-07-09,57622,1799,57205,1774,417,25,67204,918814,986018,24768,25,702,379,10662,1395,46258,118,4306,782,19
647,2020-07-08,55823,1639,55431,1615,392,24,65146,896104,961250,19566,20,677,56,10283,1563,44863,99,4188,763,12
648,2020-07-07,54184,2143,53816,2131,368,12,63246,878438,941684,27214,12,657,721,10227,1410,43300,137,4089,751,18
649,2020-07-06,52041,882,51685,869,356,13,60592,853878,914470,8281,7,645,-626,9506,1501,41890,75,3952,733,11
650,2020-07-05,51159,1337,50816,1335,343,2,59667,846522,906189,15206,9,638,565,10132,763,40389,63,3877,722,19
651,2020-07-04,49822,1453,49481,1451,341,2,58067,832916,890983,21574,4,629,617,9567,832,39626,72,3814,703,16
652,2020-07-03,48369,1340,48030,1331,339,9,56233,813176,869409,16442,13,625,302,8950,1025,38794,76,3742,687,12
653,2020-07-02,47029,1914,46699,1906,330,8,54742,798225,852967,25851,11,612,984,8648,919,37769,115,3666,675,9
654,2020-07-01,45115,1418,44793,1413,322,5,52474,774642,827116,18050,5,601,466,7664,947,36850,80,3551,666,14
655,2020-06-30,43697,1644,43380,1632,317,12,50772,758294,809066,25207,12,596,769,7198,863,35903,81,3471,652,12
656,2020-06-29,42053,1774,41748,1767,305,7,48617,735242,783859,23516,0,584,792,6429,982,35040,114,3390,640,8
657,2020-06-28,40279,654,39981,652,298,2,46588,713755,760343,9910,0,584,221,5637,433,34058,21,3276,632,8
658,2020-06-27,39625,263,39329,257,296,6,45810,704623,750433,2063,7,584,-334,5416,590,33625,28,3255,624,8
659,2020-06-26,39362,973,39072,950,290,23,45539,702831,748370,10012,10,577,290,5750,673,33035,72,3227,616,14
660,2020-06-25,38389,1066,38122,1057,267,9,44520,693838,738358,14031,11,567,428,5460,627,32362,60,3155,602,9
661,2020-06-24,37323,839,37065,831,258,8,43303,681024,724327,8622,14,556,121,5032,704,31735,57,3095,593,7
662,2020-06-23,36484,1013,36234,1006,250,7,42319,673386,715705,11329,11,542,366,4911,636,31031,67,3038,586,5
663,2020-06-22,35471,625,35228,612,243,13,41159,663217,704376,10574,5,531,-183,4545,803,30395,33,2971,581,6
664,2020-06-21,34846,590,34616,589,230,1,40502,653300,693802,13656,2,526,200,4728,388,29592,26,2938,575,10
665,2020-06-20,34256,404,34027,403,229,1,39709,640437,680146,9129,0,524,-67,4528,471,29204,31,2912,565,7
666,2020-06-19,33852,736,33624,732,228,4,39179,631838,671017,10194,15,524,209,4595,512,28733,51,2881,558,9
667,2020-06-18,33116,1094,32892,1092,224,2,38300,622523,660823,15395,12,509,496,4386,586,28221,89,2830,549,5
668,2020-06-17,32022,405,31800,401,222,4,37030,608398,645428,5621,4,497,-221,3890,622,27635,29,2741,544,10
669,2020-06-16,31617,611,31399,608,218,3,36604,603203,639807,7802,10,493,136,4111,465,27013,44,2712,534,6
670,2020-06-15,31006,706,30791,693,215,13,35911,596094,632005,10573,8,483,21,3975,677,26548,45,2668,528,15
671,2020-06-14,30300,603,30098,599,202,4,35092,586340,621432,13819,3,475,254,3954,346,25871,29,2623,513,9
672,2020-06-13,29697,537,29499,532,198,5,34348,573265,607613,10589,4,472,156,3700,377,25525,24,2594,504,7
673,2020-06-12,29160,544,28967,542,193,2,33626,563398,597024,9457,27,468,-41,3544,558,25148,38,2570,497,4
674,2020-06-11,28616,612,28425,609,191,3,33011,554556,587567,9730,5,441,-162,3585,769,24590,31,2532,493,6
675,2020-06-10,28004,427,27816,422,188,5,32305,545532,577837,8413,1,436,-173,3747,599,23821,51,2501,487,1
676,2020-06-09,27577,585,27394,580,183,5,31914,537510,569424,9392,14,435,-46,3920,617,23222,42,2450,486,4
677,2020-06-08,26992,487,26814,483,178,4,31240,528792,560032,10056,3,421,99,3966,385,22605,28,2408,482,5
678,2020-06-07,26505,426,26331,423,174,3,30681,519295,549976,13821,1,418,157,3867,268,22220,28,2380,477,5
679,2020-06-06,26079,468,25908,465,171,3,30081,506074,536155,10920,9,417,187,3710,272,21952,26,2352,472,10
680,2020-06-05,25611,510,25443,501,168,9,29517,495718,525235,11807,7,408,7,3523,496,21680,23,2326,462,6
681,2020-06-04,25101,227,24942,224,159,3,28898,484530,513428,5570,13,401,-264,3516,478,21184,21,2303,456,3
682,2020-06-03,24874,353,24718,352,156,1,28681,479177,507858,7917,7,388,-158,3780,504,20706,40,2282,453,8
683,2020-06-02,24521,644,24366,641,155,3,28254,471687,499941,14359,14,381,192,3938,438,20202,36,2242,445,7
684,2020-06-01,23877,603,23725,599,152,4,27431,458151,485582,10579,3,367,-103,3746,703,19764,24,2206,438,6
685,2020-05-31,23274,607,23126,605,148,2,26664,448339,475003,15758,0,364,394,3849,213,19061,49,2182,432,5
686,2020-05-30,22667,456,22521,455,146,1,25965,433280,459245,9708,4,364,158,3455,294,18848,24,2133,427,10
687,2020-05-29,22211,230,22066,226,145,4,25394,424143,449537,7038,4,360,-169,3297,395,18554,18,2109,417,7
688,2020-05-28,21981,596,21840,595,141,1,25125,417374,442499,9193,3,356,219,3466,374,18159,38,2091,410,4
689,2020-05-27,21385,214,21245,208,140,6,24453,408853,433306,6753,10,353,-126,3247,330,17785,28,2053,406,7
690,2020-05-26,21171,354,21037,344,134,10,24255,402298,426553,6876,5,343,-31,3373,380,17455,23,2025,399,4
691,2020-05-25,20817,594,20693,593,124,1,23857,395820,419677,11386,2,338,246,3404,346,17075,32,2002,395,6
692,2020-05-24,20223,331,20100,331,123,0,23150,385141,408291,11943,7,336,122,3158,202,16729,17,1970,389,10
693,2020-05-23,19892,418,19769,413,123,5,22720,373628,396348,11173,14,329,238,3036,166,16527,26,1953,379,6
694,2020-05-22,19474,385,19356,381,118,4,22175,363000,385175,9003,2,315,85,2798,298,16361,34,1927,373,3
695,2020-05-21,19089,383,18975,382,114,1,21726,354446,376172,6640,4,313,-256,2713,635,16063,20,1893,370,8
696,2020-05-20,18706,259,18593,258,113,1,21339,348193,369532,8400,4,309,-316,2969,571,15428,20,1873,362,5
697,2020-05-19,18447,334,18335,333,112,1,21034,340098,361132,6811,4,305,-95,3285,425,14857,30,1853,357,2
698,2020-05-18,18113,341,18002,339,111,2,20632,333689,354321,8826,3,301,-1,3380,339,14432,25,1823,355,4
699,2020-05-17,17772,471,17663,471,109,0,20208,325287,345495,14077,3,298,304,3381,164,14093,24,1798,351,7
700,2020-05-16,17301,260,17192,243,109,17,19627,311791,331418,11002,5,295,43,3077,212,13929,18,1774,344,6
701,2020-05-15,17041,193,16949,191,92,2,19271,301145,320416,8137,3,290,-194,3034,384,13717,11,1756,338,8
702,2020-05-14,16848,261,16758,260,90,1,19051,293228,312279,10152,14,287,-120,3228,367,13333,17,1745,330,15
703,2020-05-13,16587,320,16498,317,89,3,18696,283431,302127,10220,9,273,-495,3348,806,12966,30,1728,315,11
704,2020-05-12,16267,696,16181,696,86,0,18311,273596,291907,14782,13,264,-411,3843,1094,12160,25,1698,304,8
705,2020-05-11,15571,552,15485,549,86,3,17504,259621,277125,9970,8,251,179,4254,365,11066,22,1673,296,4
706,2020-05-10,15019,247,14936,244,83,3,16924,250231,267155,10212,1,243,64,4075,182,10701,13,1651,292,4
707,2020-05-09,14772,244,14692,242,80,2,16557,240386,256943,9807,1,242,10,4011,233,10519,18,1638,288,9
708,2020-05-08,14528,195,14450,194,78,1,16242,230894,247136,6575,4,241,-198,4001,389,10286,15,1620,279,6
709,2020-05-07,14333,392,14256,390,77,2,15997,224564,240561,10787,-2,237,80,4199,314,9897,30,1605,273,8
710,2020-05-06,13941,259,13866,259,75,0,15523,214251,229774,5944,13,239,-92,4119,338,9583,15,1575,265,3
711,2020-05-05,13682,189,13607,188,75,1,15201,208629,223830,7851,7,226,-140,4211,322,9245,28,1560,262,10
712,2020-05-04,13493,310,13419,306,74,4,14961,201018,215979,7076,9,219,-305,4351,606,8923,23,1532,252,6
713,2020-05-03,13183,370,13113,364,70,6,14595,194308,208903,9415,1,210,118,4656,251,8317,30,1509,246,9
714,2020-05-02,12813,237,12749,236,64,1,14146,185342,199488,7037,5,209,-100,4538,332,8066,20,1479,237,5
715,2020-05-01,12576,769,12513,764,63,5,13797,178654,192451,9536,5,204,469,4638,295,7734,20,1459,232,5
716,2020-04-30,11807,1002,11749,998,58,4,12994,169921,182915,5191,4,199,778,4169,220,7439,36,1439,227,5
717,2020-04-29,10805,568,10751,566,54,2,11951,165773,177724,10948,7,195,330,3391,231,7219,38,1403,222,5
718,2020-04-28,10237,273,10185,269,52,4,11294,155482,166776,6526,4,188,39,3061,230,6988,35,1365,217,6
719,2020-04-27,9964,297,9916,293,48,4,10991,149259,160250,5461,3,184,-15,3022,309,6758,38,1330,211,5
720,2020-04-26,9667,298,9623,297,44,1,10658,144131,154789,6697,3,181,139,3037,156,6449,21,1292,206,3
721,2020-04-25,9369,301,9326,296,43,5,10310,137782,148092,4558,10,178,131,2898,160,6293,27,1271,203,6
722,2020-04-24,9068,468,9030,459,38,9,9965,133569,143534,14206,-2,168,247,2767,223,6133,45,1244,197,5
723,2020-04-23,8600,452,8571,450,29,2,9425,119903,129328,5037,4,170,300,2520,148,5910,20,1199,192,10
724,2020-04-22,8148,499,8121,497,27,2,8945,115346,124291,9051,9,166,282,2220,208,5762,22,1179,182,3
725,2020-04-21,7649,288,7624,286,25,2,8389,106851,115240,6847,5,157,95,1938,188,5554,27,1157,179,5
726,2020-04-20,7361,250,7338,242,23,8,8059,100334,108393,6529,4,152,27,1843,219,5366,27,1130,174,4
727,2020-04-19,7111,277,7096,276,15,1,7794,94070,101864,5158,3,148,151,1816,123,5147,11,1103,170,3
728,2020-04-18,6834,173,6820,173,14,0,7472,89234,96706,5012,3,145,8,1665,162,5024,15,1092,167,2
729,2020-04-17,6661,320,6647,319,14,1,7237,84457,91694,3326,1,142,124,1657,195,4862,38,1077,165,3
730,2020-04-16,6341,290,6328,290,13,0,6870,81498,88368,4139,6,141,79,1533,205,4667,25,1039,162,6
731,2020-04-15,6051,263,6038,263,13,0,6520,77709,84229,3146,11,135,20,1454,232,4462,21,1014,156,6
732,2020-04-14,5788,182,5775,182,13,0,6212,74871,81083,1711,15,124,-49,1434,216,4230,30,993,150,10
733,2020-04-13,5606,216,5593,215,13,1,5993,73379,79372,4434,8,109,-10,1483,218,4014,41,963,140,8
734,2020-04-12,5390,225,5378,223,12,2,5725,69213,74938,5096,0,101,83,1493,142,3796,33,922,132,8
735,2020-04-11,5165,292,5155,292,10,0,5480,64362,69842,5010,3,101,27,1410,262,3654,44,889,124,7
736,2020-04-10,4873,195,4863,194,10,1,5110,59722,64832,2441,4,98,-29,1383,220,3392,26,845,117,2
737,2020-04-09,4678,279,4669,279,9,0,4916,57475,62391,3496,15,94,51,1412,213,3172,43,819,115,5
738,2020-04-08,4399,205,4390,205,9,0,4592,54303,58895,2813,7,79,-45,1361,243,2959,31,776,110,16
739,2020-04-07,4194,306,4185,306,9,0,4353,51729,56082,4851,7,72,59,1406,240,2716,43,745,94,7
740,2020-04-06,3888,228,3879,228,9,0,4030,47201,51231,3717,21,65,-71,1347,278,2476,47,702,87,7
741,2020-04-05,3660,312,3651,311,9,1,3773,43741,47514,3819,1,44,126,1418,185,2198,48,655,80,10
742,2020-04-04,3348,201,3340,201,8,0,3409,40286,43695,3475,6,43,-14,1292,209,2013,26,607,70,4
743,2020-04-03,3147,252,3139,251,8,1,3211,37009,40220,2640,5,37,3,1306,244,1804,43,581,66,16
744,2020-04-02,2895,270,2888,270,7,0,2939,34641,37580,3872,8,32,37,1303,225,1560,58,538,50,6
745,2020-04-01,2625,357,2618,357,7,0,2652,31056,33708,3767,1,24,134,1266,222,1335,59,480,44,8
746,2020-03-31,2268,287,2261,287,7,0,2265,27676,29941,2963,10,23,69,1132,208,1113,48,421,36,8
747,2020-03-30,1981,439,1974,439,7,0,1960,25018,26978,5045,6,13,227,1063,206,905,84,373,28,6
748,2020-03-29,1542,102,1535,102,7,0,1513,20420,21933,837,1,7,-46,836,147,699,36,289,22,6
749,2020-03-28,1440,196,1433,191,7,5,1412,19684,21096,2378,0,6,89,882,107,552,39,253,16,4
750,2020-03-27,1244,207,1242,207,2,0,1217,17501,18718,2803,3,6,96,793,108,445,42,214,12,2
751,2020-03-26,1037,168,1035,167,2,1,1005,14910,15915,2969,0,3,85,697,83,337,30,172,10,4
752,2020-03-25,869,157,868,157,1,0,828,12118,12946,2148,1,3,77,612,79,254,37,142,6,1
753,2020-03-24,712,85,711,85,1,0,681,10117,10798,1103,0,2,30,535,55,175,21,105,5,1
754,2020-03-23,627,122,626,122,1,0,605,9090,9695,1499,0,2,84,505,38,120,13,84,4,0
755,2020-03-22,505,133,504,132,1,1,488,7708,8196,1571,1,2,108,421,24,82,28,71,4,1
756,2020-03-21,372,151,372,151,0,0,396,6229,6625,2118,1,1,121,313,29,58,14,43,3,2
757,2020-03-20,221,162,221,162,0,0,250,4257,4507,1087,0,0,141,192,21,29,14,29,1,1
758,2020-03-19,59,30,59,30,0,0,181,3239,3420,832,0,0,22,51,8,8,9,15,0,0
759,2020-03-18,29,11,29,11,0,0,118,2470,2588,591,0,0,11,29,0,0,3,6,0,0
760,2020-03-17,18,4,18,4,0,0,84,1913,1997,1364,0,0,4,18,0,0,0,3,0,0
761,2020-03-16,14,4,14,4,0,0,27,606,633,162,0,0,4,14,0,0,2,3,0,0
762,2020-03-15,10,4,10,4,0,0,24,447,471,29,0,0,4,10,0,0,0,1,0,0
763,2020-03-14,6,5,6,5,0,0,23,419,442,353,0,0,5,6,0,0,1,1,0,0
764,2020-03-13,1,0,1,0,0,0,3,86,89,43,0,0,0,1,0,0,0,0,0,0
765,2020-03-12,1,1,1,1,0,0,3,43,46,46,0,0,1,1,0,0,0,0,0,0
